CTAAAAGACAATAACGAGC: TAAAAGACAATAACGAGCT
ATGTGTTGCGGGAGTGACC: TGTGTTGCGGGAGTGACCC
CTTTGGTTAGATGGTTTGT: TTTGGTTAGATGGTTTGTA
GCTACTCGTGTCGTCCCAT: CTACTCGTGTCGTCCCATA
TATCACAGTTTTCGCATTT: ATCACAGTTTTCGCATTTA
ACTAGTGTGTGAACTTTGC: CTAGTGTGTGAACTTTGCA
AACCGGGATGGAGTATACT: ACCGGGATGGAGTATACTC
TTGCCACAAGGTGGGAGGC: TGCCACAAGGTGGGAGGCC
CCTCCTTTATCATAGGGCG: CTCCTTTATCATAGGGCGC
TGTACCAATAATCATTGTG: GTACCAATAATCATTGTGA
GCATAGCTTGTGGCTAGGA: CATAGCTTGTGGCTAGGAG
TCCTCTCGACTCTTCTTTC: CCTCTCGACTCTTCTTTCG
CGAGTGAATCCCGGAGTTG: GAGTGAATCCCGGAGTTGG
TCCATTGCAAACACTCCCA: CCATTGCAAACACTCCCAG
GAGGCCCTCCTTTATCATA: AGGCCCTCCTTTATCATAG
ACCGGGCACATCATCACCC: CCGGGCACATCATCACCCG
CCTGTCTGATAACCGGTGC: CTGTCTGATAACCGGTGCT
CTTGCAAGGCGAAGTATTG: TTGCAAGGCGAAGTATTGC
CCCAGGATATTAACTAAAA: CCAGGATATTAACTAAAAA
CCTTTGGTTAGATGGTTTG: CTTTGGTTAGATGGTTTGT
TAACTAAAAAAACCCACAC: AACTAAAAAAACCCACACA
AATGGATGATCGTTTTTAC: ATGGATGATCGTTTTTACC
GACAATGTCCAGCATTCAG: ACAATGTCCAGCATTCAGG
CTCACCTATGAGACACTAG: TCACCTATGAGACACTAGC
GTGCAAACACTCCCAGTGA: TGCAAACACTCCCAGTGAT
GACAATCTTAATTCGCTCC: ACAATCTTAATTCGCTCCG
GATGTGAACGATCGAGAAC: ATGTGAACGATCGAGAACG
TACTGAAAAATTTAGTACG: ACTGAAAAATTTAGTACGC
CCCACACAGGCTAGGTCCG: CCACACAGGCTAGGTCCGA
GCCGGAGTTGCCACAAGGT: CCGGAGTTGCCACAAGGTG
CGTGAGTGGTTCAGCATGC: GTGAGTGGTTCAGCATGCT
GGAAGTACGTTAAGCCTGT: GAAGTACGTTAAGCCTGTT
CAGATTTCTATTGGTTGGC: AGATTTCTATTGGTTGGCC
CTAAGCGGCTAGACGTTGA: TAAGCGGCTAGACGTTGAC
CTAAAATGGATGATCGTTT: TAAAATGGATGATCGTTTT
ATTGGGATCCCAGGCATGA: TTGGGATCCCAGGCATGAG
GCACTCAGTCGTCACCGAC: CACTCAGTCGTCACCGACT
GGTAGTCACGGTCTAGCGG: GTAGTCACGGTCTAGCGGC
CTCGTTCGAGTTATAGTGA: TCGTTCGAGTTATAGTGAC
TCAGCGGACCGAGTGGAGG: CAGCGGACCGAGTGGAGGC
ACACTAGGCCCAGTGGTGT: CACTAGGCCCAGTGGTGTG
AAGATGATGCGTGAGTGGT: AGATGATGCGTGAGTGGTT
AGCCGTGAGCGAGACGCAG: GCCGTGAGCGAGACGCAGT
CTTGTCGCACGCTTCTTGT: TTGTCGCACGCTTCTTGTG
TGACAATCTTAATTCGCTC: GACAATCTTAATTCGCTCC
ACCTCATTCTTTAGCTTAG: CCTCATTCTTTAGCTTAGC
ATAAATCCCCACAAGAGTC: TAAATCCCCACAAGAGTCT
CAGCGGATAGATGCCAAAG: AGCGGATAGATGCCAAAGT
ACGAGCTCAGTGCCGCAAC: CGAGCTCAGTGCCGCAACG
CGTTGACCCCATTCTAGAT: GTTGACCCCATTCTAGATC
CCCAGTGATGATATTATTT: CCAGTGATGATATTATTTT
AAGCTCCGTGCCAAATTGC: AGCTCCGTGCCAAATTGCC
CTACCGCGGATCTATGTTG: TACCGCGGATCTATGTTGT
CTTTGGTAAAAGATGATGC: TTTGGTAAAAGATGATGCG
TCTAGCGGCCGGGATTCTA: CTAGCGGCCGGGATTCTAA
GGTTGGCCTAACCCGAGGG: GTTGGCCTAACCCGAGGGT
CGGGAGTTGTCACTCCAGG: GGGAGTTGTCACTCCAGGG
AGTGCTCATCATCCATAAA: GTGCTCATCATCCATAAAT
ACGTTAAGCCTGTTCGCGT: CGTTAAGCCTGTTCGCGTT
TGATGCGTGAGTGGTTCAG: GATGCGTGAGTGGTTCAGC
ATACTCTTGCGGAAGTACG: TACTCTTGCGGAAGTACGT
CTTCTCTTCACGAAGCCGT: TTCTCTTCACGAAGCCGTG
CGAAGCCGTGAGCGAGACG: GAAGCCGTGAGCGAGACGC
CACCTATGAGACACTAGAC: ACCTATGAGACACTAGACC
TGGCGTTGGCCGTCCTTTA: GGCGTTGGCCGTCCTTTAC
CCGATAGCCGGAGTTGCCA: CGATAGCCGGAGTTGCCAC
TGAAGTCCCGAGATATTGA: GAAGTCCCGAGATATTGAT
ACGCACCCGATACCTTTGG: CGCACCCGATACCTTTGGT
CTCCCTATGAGGGTTCCTT: TCCCTATGAGGGTTCCTTG
TGTTTCAGGATTCCGTGCC: GTTTCAGGATTCCGTGCCA
CAGCAATCACAGGGGCAGC: AGCAATCACAGGGGCAGCA
CAGGGATAGCGCACTCAGT: AGGGATAGCGCACTCAGTC
CTCCCAGTGATGATATTAT: TCCCAGTGATGATATTATT
CCGGGCACATCATCACCCG: CGGGCACATCATCACCCGC
GTGTCTCCCTATGAGGGTT: TGTCTCCCTATGAGGGTTC
CACCCGCGAAACTGCATCT: ACCCGCGAAACTGCATCTA
TGATATTATTTTACAGGCC: GATATTATTTTACAGGCCT
GTGAAGTCCCGAGATATTG: TGAAGTCCCGAGATATTGA
CGCGTTACTCCTGCGGCGA: GCGTTACTCCTGCGGCGAT
CTCCAGGGACAGAAAGGAG: TCCAGGGACAGAAAGGAGA
AACTTGTCACGTCAAAATT: ACTTGTCACGTCAAAATTA
TTTACCCCAGACCTAGTGC: TTACCCCAGACCTAGTGCC
GGCTAGGAGACTCACACAT: GCTAGGAGACTCACACATT
GGAGTGACCCGGGAGTTGT: GAGTGACCCGGGAGTTGTC
TGCGGCGATGTAGTTCCTC: GCGGCGATGTAGTTCCTCT
GAGTGGAGGCCTGCGTGAC: AGTGGAGGCCTGCGTGACC
CCTAAAAGACAATAACGAG: CTAAAAGACAATAACGAGC
ACACTCCCAGTGATTATCA: CACTCCCAGTGATTATCAC
GACTAAGCGGCTAGACGTT: ACTAAGCGGCTAGACGTTG
GTTAGATGGTTTGTACTCC: TTAGATGGTTTGTACTCCT
TTGCCTCCGTCGGACTAGT: TGCCTCCGTCGGACTAGTT
TGAGACACTAGACCGATGG: GAGACACTAGACCGATGGT
TGAAAAATTTAGTACGCCT: GAAAAATTTAGTACGCCTG
GGTCTAGCGGCCGGGATTC: GTCTAGCGGCCGGGATTCT
CGTCCTTTACCCCAGACCT: GTCCTTTACCCCAGACCTA
CCGTGTCTCCCTATGAGGG: CGTGTCTCCCTATGAGGGT
ACGGTAGGTTTATTTAATG: CGGTAGGTTTATTTAATGC
GTTCTGATGCACGATGCTC: TTCTGATGCACGATGCTCG
TCCCAGTGATGATATTATT: CCCAGTGATGATATTATTT
TGTGCAATCTTTCATCCAG: GTGCAATCTTTCATCCAGG
CATTTATTTCGCAGCTACT: ATTTATTTCGCAGCTACTC
ACCAGTCAGATAGGTTTTC: CCAGTCAGATAGGTTTTCT
ATACCTTTGGTTAGATGGT: TACCTTTGGTTAGATGGTT
CAAGTGACAATCTTAATTC: AAGTGACAATCTTAATTCG
GCGTTCCAACAGAGTTTGG: CGTTCCAACAGAGTTTGGT
AATAAGACAATGTCCAGCA: ATAAGACAATGTCCAGCAT
AGAGGGGTAGTCACGGTCT: GAGGGGTAGTCACGGTCTA
TACCGCGGATCTATGTTGT: ACCGCGGATCTATGTTGTT
CCGCGAAACTGCATCTACA: CGCGAAACTGCATCTACAC
CCCCTCCCCATCAGCGGAC: CCCTCCCCATCAGCGGACC
TGGAGTATACTCTTGCGGA: GGAGTATACTCTTGCGGAA
TGGTTAGATGGTTTGTACT: GGTTAGATGGTTTGTACTC
AGAGGTCTTATCGCCGGGT: GAGGTCTTATCGCCGGGTT
ACCATATTCTGGAGTTCCG: CCATATTCTGGAGTTCCGG
ATGAGAACCTCATTCTTTA: TGAGAACCTCATTCTTTAG
TCACAGGGGCAGCACAGTG: CACAGGGGCAGCACAGTGA
CCAGTGATTTATGTACCAA: CAGTGATTTATGTACCAAT
ACTCCTCGGAGGCAGCGGG: CTCCTCGGAGGCAGCGGGC
AGTCTGTGCAATCTTTCAT: GTCTGTGCAATCTTTCATC
GTCACGTCAAAATTACCAT: TCACGTCAAAATTACCATA
CGGTGCTTGCAAGGCGAAG: GGTGCTTGCAAGGCGAAGT
CCAAGTGACAATCTTAATT: CAAGTGACAATCTTAATTC
TTCGCATTTATTTCGCAGC: TCGCATTTATTTCGCAGCT
CACAGTGCTCATCATCCAT: ACAGTGCTCATCATCCATA
AGACGTTCTATTTCACCGG: GACGTTCTATTTCACCGGG
TTGAGTCACCTATGAGACA: TGAGTCACCTATGAGACAC
CAATCTTTCATCCAGGCTT: AATCTTTCATCCAGGCTTG
CATCACCCGCACCCGCGAA: ATCACCCGCACCCGCGAAA
TCACCTATGAGACACTAGC: CACCTATGAGACACTAGCA
GGCCTCGCTTTTGAGTCCT: GCCTCGCTTTTGAGTCCTA
CCGACTAAGCGGCTAGACG: CGACTAAGCGGCTAGACGT
TTCGCGTTACTCCTGCGGC: TCGCGTTACTCCTGCGGCG
TACCCCTCCCCATCAGCGG: ACCCCTCCCCATCAGCGGA
CCTGGTTTTCACTTTACAT: CTGGTTTTCACTTTACATT
GCTGCGTCGAATAACTTGT: CTGCGTCGAATAACTTGTC
TGGACCTAAAAGACAATAA: GGACCTAAAAGACAATAAC
CAGAGTTTGGTCCTTTATG: AGAGTTTGGTCCTTTATGA
CGATGGTTATGCAAACACT: GATGGTTATGCAAACACTC
AAAAAACCCACACAGGCTA: AAAAACCCACACAGGCTAG
CATCATCACCCGCACCCGC: ATCATCACCCGCACCCGCG
GAAAGCTCCGTGCCAAATT: AAAGCTCCGTGCCAAATTG
GACCCGGGAGTTGTCACTC: ACCCGGGAGTTGTCACTCC
GTGAACTTTGCAAACACTC: TGAACTTTGCAAACACTCC
ATGAGACACTAGACCGATG: TGAGACACTAGACCGATGG
TTGGCATAGCTTGTGGCTA: TGGCATAGCTTGTGGCTAG
CGATCGAGAACGCGTATTA: GATCGAGAACGCGTATTAA
ACTAGACCGATGGTTATGC: CTAGACCGATGGTTATGCA
CTCAGTGCCGCAACGCACC: TCAGTGCCGCAACGCACCA
AGTACGTTAAGCCTGTTCG: GTACGTTAAGCCTGTTCGC
GGCATGCTGCGTCGAATAA: GCATGCTGCGTCGAATAAC
AAGAGTCTAAAATGGATGA: AGAGTCTAAAATGGATGAT
CTGGTAGTCAGGTAAAGTG: TGGTAGTCAGGTAAAGTGA
ATATTTCACCTATGAGACA: TATTTCACCTATGAGACAC
TCATTGTGAGTCTTGTCGC: CATTGTGAGTCTTGTCGCA
GTGAGTGGTTCAGCATGCT: TGAGTGGTTCAGCATGCTA
TCAGGTAAAGTGACGAGAA: CAGGTAAAGTGACGAGAAA
AGTATACTCTTGCGGAAGT: GTATACTCTTGCGGAAGTA
GTACCCCTCCCCATCAGCG: TACCCCTCCCCATCAGCGG
GTGTTGCGGGAGTGACCCG: TGTTGCGGGAGTGACCCGG
CTCCTTTATCATAGGGCGC: TCCTTTATCATAGGGCGCG
ATGTAGTTCCTCTCGACTC: TGTAGTTCCTCTCGACTCT
GCCTGGTTTTCACTTTACA: CCTGGTTTTCACTTTACAT
TTAGTACGCCTGTACTTGG: TAGTACGCCTGTACTTGGG
CTGAAAAATTTAGTACGCC: TGAAAAATTTAGTACGCCT
GCTGGGATGTGAACGATCG: CTGGGATGTGAACGATCGA
TGCACGATGCTCGTTAGGC: GCACGATGCTCGTTAGGCG
ACGCTGCTCACCTATGAGA: CGCTGCTCACCTATGAGAC
AATCACAGTCGCGGCTGTC: ATCACAGTCGCGGCTGTCA
TAATTCGCTCCGTGTCTCC: AATTCGCTCCGTGTCTCCC
TACTCTTGCGGAAGTACGT: ACTCTTGCGGAAGTACGTT
CCTATGAGACACTAGTGTG: CTATGAGACACTAGTGTGT
TGGGCCTGTCTGATAACCG: GGGCCTGTCTGATAACCGG
TCCCAGTGATTTATGTACC: CCCAGTGATTTATGTACCA
GGTTCAGCGGATAGATGCC: GTTCAGCGGATAGATGCCA
TTGATTGGCATAGCTTGTG: TGATTGGCATAGCTTGTGG
GTTGGCCTAACCCGAGGGT: TTGGCCTAACCCGAGGGTT
GCGTATTAAGGTCCGATAG: CGTATTAAGGTCCGATAGC
GATCTACATCACGGGCAAT: ATCTACATCACGGGCAATA
TTCCCTGGGCGAGACGTTC: TCCCTGGGCGAGACGTTCT
ACAATCTTAATTCGCTCCG: CAATCTTAATTCGCTCCGT
GTCACCGACTAAGCGGCTA: TCACCGACTAAGCGGCTAG
CCACAAGGTGGGAGGCCAA: CACAAGGTGGGAGGCCAAC
CTTGATCAAGGGCCTGGTT: TTGATCAAGGGCCTGGTTT
GAGTATACTCTTGCGGAAG: AGTATACTCTTGCGGAAGT
TGGGCGAGACGTTCTATTT: GGGCGAGACGTTCTATTTC
ATTTGGGTAATTGAGTCAC: TTTGGGTAATTGAGTCACC
CGGACTAGTTTCTCGTTCG: GGACTAGTTTCTCGTTCGA
GGGATTCTAATAAGACAAT: GGATTCTAATAAGACAATG
CACAGTGATGCCGGCCATC: ACAGTGATGCCGGCCATCC
AGACAATGTCCAGCATTCA: GACAATGTCCAGCATTCAG
CTCTCGACTCTTCTTTCGC: TCTCGACTCTTCTTTCGCA
TTCTGATGCACGATGCTCG: TCTGATGCACGATGCTCGT
GTGGCTGGGATGTGAACGA: TGGCTGGGATGTGAACGAT
AAACACTCCCAGTGATTTA: AACACTCCCAGTGATTTAT
GTGAGTCTTGTCGCACGCT: TGAGTCTTGTCGCACGCTT
ACCCGGGAGTTGTCACTCC: CCCGGGAGTTGTCACTCCA
AGGTAGATCGGACTCCAGG: GGTAGATCGGACTCCAGGC
GGGACAGAAAGGAGATCCC: GGACAGAAAGGAGATCCCA
GAAACTGCATCTACACCGG: AAACTGCATCTACACCGGT
AGTTATCCATTGCAAACAC: GTTATCCATTGCAAACACT
GCCTGTCTGATAACCGGTG: CCTGTCTGATAACCGGTGC
GCTTAGTGAAGTCCCGAGA: CTTAGTGAAGTCCCGAGAT
GTTGCGGGAGTGACCCGGG: TTGCGGGAGTGACCCGGGA
TTTTACCCCATTCTTCTCT: TTTACCCCATTCTTCTCTA
GGTGCTTGCAAGGCGAAGT: GTGCTTGCAAGGCGAAGTA
GCTTTTGAGTCCTAAAGAA: CTTTTGAGTCCTAAAGAAA
TTGAGGCCCTCCTTTATCA: TGAGGCCCTCCTTTATCAT
TGATCGTTTTTACCCCATT: GATCGTTTTTACCCCATTC
ACTCCCAGTGATGATATTA: CTCCCAGTGATGATATTAT
GCACGATGCTCGTTAGGCG: CACGATGCTCGTTAGGCGA
CGCCTGTACTTGGGTTATT: GCCTGTACTTGGGTTATTT
GGTAAAGTGACGAGAAATA: GTAAAGTGACGAGAAATAA
TAGCTTGTGGCTAGGAGAC: AGCTTGTGGCTAGGAGACT
GTTCCAACAGAGTTTGGTC: TTCCAACAGAGTTTGGTCC
TAGGAAACACCCGGGTGAC: AGGAAACACCCGGGTGACT
ATCCTTGATCAAGGGCCTG: TCCTTGATCAAGGGCCTGG
TAATCATTGTGAGTCTTGT: AATCATTGTGAGTCTTGTC
GAAAGACGTACCCCTCCCC: AAAGACGTACCCCTCCCCA
CATCACGGGCAATATAGGA: ATCACGGGCAATATAGGAA
GAACGATCGAGAACGCGTA: AACGATCGAGAACGCGTAT
ACTCCCAGTGATTTATGTA: CTCCCAGTGATTTATGTAC
ATCAGAGAGGGGTAGTCAC: TCAGAGAGGGGTAGTCACG
CGATGCTCGTTAGGCGAGT: GATGCTCGTTAGGCGAGTA
TTAATTCGCTCCGTGTCTC: TAATTCGCTCCGTGTCTCC
ACGTACCCCTCCCCATCAG: CGTACCCCTCCCCATCAGC
GGTCCGATAGCCGGAGTTG: GTCCGATAGCCGGAGTTGC
CGCTGGACCTAGACGTGGC: GCTGGACCTAGACGTGGCT
GTACCAATAATCATTGTGA: TACCAATAATCATTGTGAG
TTTACAGGCCTCGCTTTTG: TTACAGGCCTCGCTTTTGA
TCTTTCGCAGCACCGGCGT: CTTTCGCAGCACCGGCGTC
AGCCGGAGTTGCCACAAGG: GCCGGAGTTGCCACAAGGT
CTAAAGAAAGACGTACCCC: TAAAGAAAGACGTACCCCT
GCTTGAGGCCCTCCTTTAT: CTTGAGGCCCTCCTTTATC
ATTTATGTACCAATAATCA: TTTATGTACCAATAATCAT
AACACTCCCAGTGATTTCT: ACACTCCCAGTGATTTCTT
GCACCCGCGAAACTGCATC: CACCCGCGAAACTGCATCT
TTGGTCCTTTATGAGTAAC: TGGTCCTTTATGAGTAACA
CATGGTTAGTCCTCGCCCT: ATGGTTAGTCCTCGCCCTC
GGGCAATATAGGAAAGCTC: GGCAATATAGGAAAGCTCC
GCTAAACCGGGATGGAGTA: CTAAACCGGGATGGAGTAT
TTGACCCCATTCTAGATCT: TGACCCCATTCTAGATCTA
AGCATTCAGGCATGCTGCG: GCATTCAGGCATGCTGCGT
TACCCCATTCTTCTCTACC: ACCCCATTCTTCTCTACCG
ATCAGCGGACCGAGTGGAG: TCAGCGGACCGAGTGGAGG
ACCTTTGGTTAGATGGTTT: CCTTTGGTTAGATGGTTTG
CGAGTGGAGGCCTGCGTGA: GAGTGGAGGCCTGCGTGAC
CTCGGAGGCAGCGGGCCAT: TCGGAGGCAGCGGGCCATT
GTGTGTGAACTTTGCAAAC: TGTGTGAACTTTGCAAACA
ATTTCACCTATGAGACACT: TTTCACCTATGAGACACTA
AGATGGTTTGTACTCCTCG: GATGGTTTGTACTCCTCGG
CATAAATCCCCACAAGAGT: ATAAATCCCCACAAGAGTC
TGGATTAGGTAGATCGGAC: GGATTAGGTAGATCGGACT
ATCGCCGGGTTTATCAGAG: TCGCCGGGTTTATCAGAGA
GAATCCCGGAGTTGGATTA: AATCCCGGAGTTGGATTAG
TGAGACACTAGGCCCAGTG: GAGACACTAGGCCCAGTGG
TAGTCGTCCGAAAACAAAG: AGTCGTCCGAAAACAAAGG
GTGAATCCCGGAGTTGGAT: TGAATCCCGGAGTTGGATT
ATTGATACAGCTCAGGGAT: TTGATACAGCTCAGGGATA
CGCACGCTTCTTGTGGACC: GCACGCTTCTTGTGGACCT
ATCCATTGCAAACACTCCC: TCCATTGCAAACACTCCCA
AGTGATGCCGGCCATCCTT: GTGATGCCGGCCATCCTTG
ATGAGGGTTCCTTGAATTG: TGAGGGTTCCTTGAATTGG
CAGCTCAGGGATAGCGCAC: AGCTCAGGGATAGCGCACT
GGCATAGCTTGTGGCTAGG: GCATAGCTTGTGGCTAGGA
GGGTTCCTTGAATTGGGGG: GGTTCCTTGAATTGGGGGA
TCCAGCATTCAGGCATGCT: CCAGCATTCAGGCATGCTG
TCAGGCATGCTGCGTCGAA: CAGGCATGCTGCGTCGAAT
CAGTCAGATAGGTTTTCTG: AGTCAGATAGGTTTTCTGG
ATACCAGCCATACTGAAAA: TACCAGCCATACTGAAAAA
CAGATAGGTTTTCTGGCGT: AGATAGGTTTTCTGGCGTT
ATGCAAACACTCCCAGTGA: TGCAAACACTCCCAGTGAT
CGCCGGGTTTATCAGAGAG: GCCGGGTTTATCAGAGAGG
TCTTCTTTCGCAGCACCGG: CTTCTTTCGCAGCACCGGC
ACACTAGTGTGTGAACTTT: CACTAGTGTGTGAACTTTG
AGGAGAGAGGTCTTATCGC: GGAGAGAGGTCTTATCGCC
GGTTTGTACTCCTCGGAGG: GTTTGTACTCCTCGGAGGC
GTTCGAGTTATAGTGACGC: TTCGAGTTATAGTGACGCT
TGTGGCTAGGAGACTCACA: GTGGCTAGGAGACTCACAC
GCTGTCACTAATTTGCCTC: CTGTCACTAATTTGCCTCC
ATGTGAACGATCGAGAACG: TGTGAACGATCGAGAACGC
GCTCAGGGATAGCGCACTC: CTCAGGGATAGCGCACTCA
AAAGTGACGAGAAATAATA: AAGTGACGAGAAATAATAC
TAAGACAATGTCCAGCATT: AAGACAATGTCCAGCATTC
CAAAGGAGAGAGGTCTTAT: AAAGGAGAGAGGTCTTATC
GGTTTATCAGAGAGGGGTA: GTTTATCAGAGAGGGGTAG
CGTACCCCTCCCCATCAGC: GTACCCCTCCCCATCAGCG
AGAGTTTGGTCCTTTATGA: GAGTTTGGTCCTTTATGAG
TCACGGTCTAGCGGCCGGG: CACGGTCTAGCGGCCGGGA
ACAGGCTAGGTCCGATATC: CAGGCTAGGTCCGATATCT
GAAAACAAAGGAGAGAGGT: AAAACAAAGGAGAGAGGTC
CACTCCCAGTGATGATATT: ACTCCCAGTGATGATATTA
CCGGATGTTCCCGGGCGCT: CGGATGTTCCCGGGCGCTG
TTGGTAAAAGATGATGCGT: TGGTAAAAGATGATGCGTG
GAGTGAATCCCGGAGTTGG: AGTGAATCCCGGAGTTGGA
TCTTAATTCGCTCCGTGTC: CTTAATTCGCTCCGTGTCT
GGATTAGGTAGATCGGACT: GATTAGGTAGATCGGACTC
CATATTTCACCTATGAGAC: ATATTTCACCTATGAGACA
AGATATTGATCATTTCCAA: GATATTGATCATTTCCAAC
TCTGGAGTTCCGGATGTTC: CTGGAGTTCCGGATGTTCC
TCTTTAGCTTAGCACACAG: CTTTAGCTTAGCACACAGT
ACTAGGCCCAGTGGTGTGC: CTAGGCCCAGTGGTGTGCA
CAATCACAGGGGCAGCACA: AATCACAGGGGCAGCACAG
AGGCATGAGAACCTCATTC: GGCATGAGAACCTCATTCT
TGTCGTCCCATAGCATGGT: GTCGTCCCATAGCATGGTT
ACAATGTCCAGCATTCAGG: CAATGTCCAGCATTCAGGC
CTACCCCCGTGTCTTCGCT: TACCCCCGTGTCTTCGCTT
TGGTAGTCAGGTAAAGTGA: GGTAGTCAGGTAAAGTGAC
GATACCTTTGGTTAGATGG: ATACCTTTGGTTAGATGGT
GATGTTCCCGGGCGCTGTG: ATGTTCCCGGGCGCTGTGC
CCCTATGAGGGTTCCTTGA: CCTATGAGGGTTCCTTGAA
TCCGTGCCATAGGAAACAC: CCGTGCCATAGGAAACACC
ACCCCAGACCTAGTGCCTA: CCCCAGACCTAGTGCCTAC
TTGAGTCCTAAAGAAAGAC: TGAGTCCTAAAGAAAGACG
AATCACAGGGGCAGCACAG: ATCACAGGGGCAGCACAGT
TTCATCCAGGCTTGAGGCC: TCATCCAGGCTTGAGGCCC
TACCCCCGTGTCTTCGCTT: ACCCCCGTGTCTTCGCTTA
ATTTCCAACAGCAATCACA: TTTCCAACAGCAATCACAG
ATCACGGGCAATATAGGAA: TCACGGGCAATATAGGAAA
TCTGATGCACGATGCTCGT: CTGATGCACGATGCTCGTT
CACTAGCAGTTATCCATTG: ACTAGCAGTTATCCATTGC
TTCTTCTCTTCACGAAGCC: TCTTCTCTTCACGAAGCCG
GTTTATCAGAGAGGGGTAG: TTTATCAGAGAGGGGTAGT
TTCCTTTGGTAAAAGATGA: TCCTTTGGTAAAAGATGAT
AGGGTTCCTTGAATTGGGG: GGGTTCCTTGAATTGGGGG
CCGGGTTTATCAGAGAGGG: CGGGTTTATCAGAGAGGGG
TCAAGGGCCTGGTTTTCAC: CAAGGGCCTGGTTTTCACT
AGGGGCAGCACAGTGATGC: GGGGCAGCACAGTGATGCC
TCACGAAGCCGTGAGCGAG: CACGAAGCCGTGAGCGAGA
GACACTAGGCCCAGTGGTG: ACACTAGGCCCAGTGGTGT
GACACTAGACCGATGGTTA: ACACTAGACCGATGGTTAT
GGAGGCCGTAGCCCAAGCA: GAGGCCGTAGCCCAAGCAC
TTTCACCGGGCACATCATC: TTCACCGGGCACATCATCA
GCCGCAACGCACCAAGTGA: CCGCAACGCACCAAGTGAC
CAAGGACCTTATCACCTAT: AAGGACCTTATCACCTATG
AGGTAAAGTGACGAGAAAT: GGTAAAGTGACGAGAAATA
GATGCCGGCCATCCTTGAT: ATGCCGGCCATCCTTGATC
AGTTGGATTAGGTAGATCG: GTTGGATTAGGTAGATCGG
AGCATGCTAAACCGGGATG: GCATGCTAAACCGGGATGG
GTCCCGAGATATTGATCAT: TCCCGAGATATTGATCATT
AAGTACGTTAAGCCTGTTC: AGTACGTTAAGCCTGTTCG
CATTGTGAGTCTTGTCGCA: ATTGTGAGTCTTGTCGCAC
ACTCGTGTCGTCCCATAGC: CTCGTGTCGTCCCATAGCA
ATGATGCGTGAGTGGTTCA: TGATGCGTGAGTGGTTCAG
TATCCATTGCAAACACTCC: ATCCATTGCAAACACTCCC
GTCTCCCTATGAGGGTTCC: TCTCCCTATGAGGGTTCCT
CCGAGTGGAGGCCTGCGTG: CGAGTGGAGGCCTGCGTGA
CACTAGTGTGTGAACTTTG: ACTAGTGTGTGAACTTTGC
TCACCTATGAGACACTAGG: CACCTATGAGACACTAGGC
GGTTATGCAAACACTCCCA: GTTATGCAAACACTCCCAG
ACGAAGCCGTGAGCGAGAC: CGAAGCCGTGAGCGAGACG
GTCACTCCAGGGACAGAAA: TCACTCCAGGGACAGAAAG
ATCGGACTCCAGGCTTGCG: TCGGACTCCAGGCTTGCGT
CTTAATTCGCTCCGTGTCT: TTAATTCGCTCCGTGTCTC
GATGATATTATTTTACAGG: ATGATATTATTTTACAGGC
TCATTCTTTAGCTTAGCAC: CATTCTTTAGCTTAGCACA
TGCCGGCCATCCTTGATCA: GCCGGCCATCCTTGATCAA
TCTCTACCGCGGATCTATG: CTCTACCGCGGATCTATGT
CCGTAGCCCAAGCACGACT: CGTAGCCCAAGCACGACTA
ACAGTTTTCGCATTTATTT: CAGTTTTCGCATTTATTTC
TGCGTTCCAACAGAGTTTG: GCGTTCCAACAGAGTTTGG
TCGCGGCTGTCACTAATTT: CGCGGCTGTCACTAATTTG
GTCAGACCAGTCAGATAGG: TCAGACCAGTCAGATAGGT
GGCAATATAGGAAAGCTCC: GCAATATAGGAAAGCTCCG
ATCATCCATAAATCCCCAC: TCATCCATAAATCCCCACA
AACGCACCAAGTGACAATC: ACGCACCAAGTGACAATCT
GCACGACTAGTCGTCCGAA: CACGACTAGTCGTCCGAAA
ACGAGAAATAATACCAGCC: CGAGAAATAATACCAGCCA
GTCCCATAGCATGGTTAGT: TCCCATAGCATGGTTAGTC
AGTGATTTCTTCTCTTCAC: GTGATTTCTTCTCTTCACG
TATGAGACACTAGGCCCAG: ATGAGACACTAGGCCCAGT
TTGTGAGTCTTGTCGCACG: TGTGAGTCTTGTCGCACGC
ATGAGACACTAGGCCCAGT: TGAGACACTAGGCCCAGTG
GTGCCTACCTTGCAACACC: TGCCTACCTTGCAACACCA
TCAGGGATAGCGCACTCAG: CAGGGATAGCGCACTCAGT
AGAGAGGGGTAGTCACGGT: GAGAGGGGTAGTCACGGTC
ATCAAGGGCCTGGTTTTCA: TCAAGGGCCTGGTTTTCAC
TGTACTTGGGTTATTTGGG: GTACTTGGGTTATTTGGGT
GAGAGGTCTTATCGCCGGG: AGAGGTCTTATCGCCGGGT
GTGACCGATCCCGCCAAGG: TGACCGATCCCGCCAAGGA
CTGGGCGAGACGTTCTATT: TGGGCGAGACGTTCTATTT
GTTTTCTGGCGTTGGCCGT: TTTTCTGGCGTTGGCCGTC
TCAGAGAGGGGTAGTCACG: CAGAGAGGGGTAGTCACGG
CAATAACGAGCTCAGTGCC: AATAACGAGCTCAGTGCCG
GGGTAGTCACGGTCTAGCG: GGTAGTCACGGTCTAGCGG
GACCGAGTGGAGGCCTGCG: ACCGAGTGGAGGCCTGCGT
CCAGTGATGATATTATTTT: CAGTGATGATATTATTTTA
GTCCGATAGCCGGAGTTGC: TCCGATAGCCGGAGTTGCC
ACTCTTCTTTCGCAGCACC: CTCTTCTTTCGCAGCACCG
CACTCCCAGTGATTATCAC: ACTCCCAGTGATTATCACA
TTTTTACCCCATTCTTCTC: TTTTACCCCATTCTTCTCT
AGGGCGCGCTGGACCTAGA: GGGCGCGCTGGACCTAGAC
CTAGGAGACTCACACATTG: TAGGAGACTCACACATTGG
AGACACTAGACCGATGGTT: GACACTAGACCGATGGTTA
ATTTCTTCTCTTCACGAAG: TTTCTTCTCTTCACGAAGC
ATGTCCAGCATTCAGGCAT: TGTCCAGCATTCAGGCATG
CTCCGTGCCAAATTGCCAT: TCCGTGCCAAATTGCCATG
TCCCTGGGCGAGACGTTCT: CCCTGGGCGAGACGTTCTA
ACACAGTGCTCATCATCCA: CACAGTGCTCATCATCCAT
TCCTCGCCCTCTTAATTAA: CCTCGCCCTCTTAATTAAT
TTCAGGCATGCTGCGTCGA: TCAGGCATGCTGCGTCGAA
TCCGTGTCTCCCTATGAGG: CCGTGTCTCCCTATGAGGG
CATGAGAACCTCATTCTTT: ATGAGAACCTCATTCTTTA
ACACCCGGGTGACTAGTCT: CACCCGGGTGACTAGTCTG
ATTACCATATTCTGGAGTT: TTACCATATTCTGGAGTTC
GCATGAGAACCTCATTCTT: CATGAGAACCTCATTCTTT
GGCTTGCGTTCCAACAGAG: GCTTGCGTTCCAACAGAGT
GCACCCGATACCTTTGGTT: CACCCGATACCTTTGGTTA
TGATGATATTATTTTACAG: GATGATATTATTTTACAGG
GTGACTAGTCTGTGCAATC: TGACTAGTCTGTGCAATCT
ACGCGTATTAAGGTCCGAT: CGCGTATTAAGGTCCGATA
ACTGAAAAATTTAGTACGC: CTGAAAAATTTAGTACGCC
ATGAGACACTAGCAGTTAT: TGAGACACTAGCAGTTATC
GAGAACGCGTATTAAGGTC: AGAACGCGTATTAAGGTCC
ATCTCCGAGTGAATCCCGG: TCTCCGAGTGAATCCCGGA
CTTCTCTACCGCGGATCTA: TTCTCTACCGCGGATCTAT
CGCCCTCTTAATTAATCAC: GCCCTCTTAATTAATCACA
CCATTGCAAACACTCCCAG: CATTGCAAACACTCCCAGT
ATACAGCTCAGGGATAGCG: TACAGCTCAGGGATAGCGC
AACAGCAATCACAGGGGCA: ACAGCAATCACAGGGGCAG
GGCGAGTACGGTAGGTTTA: GCGAGTACGGTAGGTTTAT
GATGCACGATGCTCGTTAG: ATGCACGATGCTCGTTAGG
TCTAATAAGACAATGTCCA: CTAATAAGACAATGTCCAG
ACTCTTGCGGAAGTACGTT: CTCTTGCGGAAGTACGTTA
TGATGCACGATGCTCGTTA: GATGCACGATGCTCGTTAG
CCTATGAGACACTAGCAGT: CTATGAGACACTAGCAGTT
ATGGTTTGTACTCCTCGGA: TGGTTTGTACTCCTCGGAG
CCGCGGATCTATGTTGTTT: CGCGGATCTATGTTGTTTC
CAGGATATTAACTAAAAAA: AGGATATTAACTAAAAAAA
GATGATCGTTTTTACCCCA: ATGATCGTTTTTACCCCAT
GTTTGTACTCCTCGGAGGC: TTTGTACTCCTCGGAGGCA
GCTCCGTGCCAAATTGCCA: CTCCGTGCCAAATTGCCAT
TCCTGCGGCGATGTAGTTC: CCTGCGGCGATGTAGTTCC
CGGATGTTCCCGGGCGCTG: GGATGTTCCCGGGCGCTGT
CGCTATCTCCGAGTGAATC: GCTATCTCCGAGTGAATCC
ATAGATGCCAAAGTTGATT: TAGATGCCAAAGTTGATTG
TGGAGGCCTGCGTGACCGA: GGAGGCCTGCGTGACCGAT
ACTAGTCTGTGCAATCTTT: CTAGTCTGTGCAATCTTTC
GTGCCATAGGAAACACCCG: TGCCATAGGAAACACCCGG
ACCTATGAGACACTAGTGT: CCTATGAGACACTAGTGTG
GATAACCGGTGCTTGCAAG: ATAACCGGTGCTTGCAAGG
GGCGATGTAGTTCCTCTCG: GCGATGTAGTTCCTCTCGA
ATGCGTGAGTGGTTCAGCA: TGCGTGAGTGGTTCAGCAT
AACCGGTGCTTGCAAGGCG: ACCGGTGCTTGCAAGGCGA
CTTCCCTGGGCGAGACGTT: TTCCCTGGGCGAGACGTTC
GCGAGACGTTCTATTTCAC: CGAGACGTTCTATTTCACC
CCCGGAGTTGGATTAGGTA: CCGGAGTTGGATTAGGTAG
GATCAAGGGCCTGGTTTTC: ATCAAGGGCCTGGTTTTCA
TAGCGCACTCAGTCGTCAC: AGCGCACTCAGTCGTCACC
TTGTCGCACGCTTCTTGTG: TGTCGCACGCTTCTTGTGG
AGTGACAATCTTAATTCGC: GTGACAATCTTAATTCGCT
GAGGGGTAGTCACGGTCTA: AGGGGTAGTCACGGTCTAG
TGACGCTGCTCACCTATGA: GACGCTGCTCACCTATGAG
ATGGATGATCGTTTTTACC: TGGATGATCGTTTTTACCC
AGGACCTTATCACCTATGA: GGACCTTATCACCTATGAG
TAGGCGAGTACGGTAGGTT: AGGCGAGTACGGTAGGTTT
ACCAGCCATACTGAAAAAT: CCAGCCATACTGAAAAATT
TGCTCACCTATGAGACACT: GCTCACCTATGAGACACTA
GTAATTGAGTCACCTATGA: TAATTGAGTCACCTATGAG
AGCCATACTGAAAAATTTA: GCCATACTGAAAAATTTAG
TCATCACCCGCACCCGCGA: CATCACCCGCACCCGCGAA
TGCAAACACTCCCAGTGAT: GCAAACACTCCCAGTGATT GCAAACACTCCCAGTGATT GCAAACACTCCCAGTGATT GCAAACACTCCCAGTGATG
TGATAACCGGTGCTTGCAA: GATAACCGGTGCTTGCAAG
GCATCTACACCGGTTTGGG: CATCTACACCGGTTTGGGC
GCACACAGTGCTCATCATC: CACACAGTGCTCATCATCC
TAAAGTGACGAGAAATAAT: AAAGTGACGAGAAATAATA
ACCTTGCAACACCAGATTT: CCTTGCAACACCAGATTTC
CACATCATCACCCGCACCC: ACATCATCACCCGCACCCG
CATCATCCATAAATCCCCA: ATCATCCATAAATCCCCAC
GGCCGGGATTCTAATAAGA: GCCGGGATTCTAATAAGAC
AGACTCACACATTGGGATC: GACTCACACATTGGGATCC
AGTGATTATCACAGTTTTC: GTGATTATCACAGTTTTCG
GGGAGTGACCCGGGAGTTG: GGAGTGACCCGGGAGTTGT
AGTGAATCCCGGAGTTGGA: GTGAATCCCGGAGTTGGAT
GGATGTTCCCGGGCGCTGT: GATGTTCCCGGGCGCTGTG
CAGCACCGGCGTCAGACCA: AGCACCGGCGTCAGACCAG
GCGCACTCAGTCGTCACCG: CGCACTCAGTCGTCACCGA
CAATATAGGAAAGCTCCGT: AATATAGGAAAGCTCCGTG
GGCACATCATCACCCGCAC: GCACATCATCACCCGCACC
GGCGAAGTATTGCGCAGGG: GCGAAGTATTGCGCAGGGG
CGGGTGACTAGTCTGTGCA: GGGTGACTAGTCTGTGCAA
CCTTGAATTGGGGGAGGCC: CTTGAATTGGGGGAGGCCG
TCTCCCTATGAGGGTTCCT: CTCCCTATGAGGGTTCCTT
ATAGTGACGCTGCTCACCT: TAGTGACGCTGCTCACCTA
CGCTTAGTGAAGTCCCGAG: GCTTAGTGAAGTCCCGAGA
AACGCGTATTAAGGTCCGA: ACGCGTATTAAGGTCCGAT
ACTGCATCTACACCGGTTT: CTGCATCTACACCGGTTTG
ATAAGACAATGTCCAGCAT: TAAGACAATGTCCAGCATT
AGCACACAGTGCTCATCAT: GCACACAGTGCTCATCATC
TTTCTCGTTCGAGTTATAG: TTCTCGTTCGAGTTATAGT
TTCTCGTTCGAGTTATAGT: TCTCGTTCGAGTTATAGTG
GTAGTCACGGTCTAGCGGC: TAGTCACGGTCTAGCGGCC
ACACCAGATTTCTATTGGT: CACCAGATTTCTATTGGTT
GTTTCTCGTTCGAGTTATA: TTTCTCGTTCGAGTTATAG
TACACCGGTTTGGGCCTGT: ACACCGGTTTGGGCCTGTC
CACGGTCTAGCGGCCGGGA: ACGGTCTAGCGGCCGGGAT
TCTTGTGGACCTAAAAGAC: CTTGTGGACCTAAAAGACA
GGATTCTAATAAGACAATG: GATTCTAATAAGACAATGT
GGTAGTCAGGTAAAGTGAC: GTAGTCAGGTAAAGTGACG
CGGACTCCAGGCTTGCGTT: GGACTCCAGGCTTGCGTTC
GACCTTATCACCTATGAGA: ACCTTATCACCTATGAGAC
TCACCGACTAAGCGGCTAG: CACCGACTAAGCGGCTAGA
AGGTTTTCTGGCGTTGGCC: GGTTTTCTGGCGTTGGCCG
CACCGACTAAGCGGCTAGA: ACCGACTAAGCGGCTAGAC
CACCTATGAGACACTAGCA: ACCTATGAGACACTAGCAG
CGGGATTCTAATAAGACAA: GGGATTCTAATAAGACAAT
GCGGCGATGTAGTTCCTCT: CGGCGATGTAGTTCCTCTC
ATCTATGTTGTTTCAGGAT: TCTATGTTGTTTCAGGATT
ATGCTAAACCGGGATGGAG: TGCTAAACCGGGATGGAGT
GATCATTTCCAACAGCAAT: ATCATTTCCAACAGCAATC
TAGTCCTCGCCCTCTTAAT: AGTCCTCGCCCTCTTAATT
GAAGCCGTGAGCGAGACGC: AAGCCGTGAGCGAGACGCA
GGCCCTCCTTTATCATAGG: GCCCTCCTTTATCATAGGG
ACCTTATCACCTATGAGAC: CCTTATCACCTATGAGACA
GACCCCATTCTAGATCTAC: ACCCCATTCTAGATCTACA
ACAAGGTGGGAGGCCAACC: CAAGGTGGGAGGCCAACCT
AAGGTCCGATAGCCGGAGT: AGGTCCGATAGCCGGAGTT
TAGCCCAAGCACGACTAGT: AGCCCAAGCACGACTAGTC
CGAGACGCAGTCGTTCTGA: GAGACGCAGTCGTTCTGAT
CGTCAGACCAGTCAGATAG: GTCAGACCAGTCAGATAGG
AACAAAGGAGAGAGGTCTT: ACAAAGGAGAGAGGTCTTA
TCGTTCTGATGCACGATGC: CGTTCTGATGCACGATGCT
CGTTCTATTTCACCGGGCA: GTTCTATTTCACCGGGCAC
CGGGAGTGACCCGGGAGTT: GGGAGTGACCCGGGAGTTG
TCCTTTACCCCAGACCTAG: CCTTTACCCCAGACCTAGT
GGGCGCTGTGCCCAGGATA: GGCGCTGTGCCCAGGATAT
TCAGTGCCGCAACGCACCA: CAGTGCCGCAACGCACCAA
AGTTCCTCTCGACTCTTCT: GTTCCTCTCGACTCTTCTT
ACGGTCTAGCGGCCGGGAT: CGGTCTAGCGGCCGGGATT
CGCTTCTTGTGGACCTAAA: GCTTCTTGTGGACCTAAAA
GATTTCTTCTCTTCACGAA: ATTTCTTCTCTTCACGAAG
CTGTTCGCGTTACTCCTGC: TGTTCGCGTTACTCCTGCG
AAGCGGCTAGACGTTGACC: AGCGGCTAGACGTTGACCC
TTTAATGCTACCCCCGTGT: TTAATGCTACCCCCGTGTC
GATTCCGTGCCATAGGAAA: ATTCCGTGCCATAGGAAAC
CCAGCATTCAGGCATGCTG: CAGCATTCAGGCATGCTGC
GCTAGGAGACTCACACATT: CTAGGAGACTCACACATTG
GTGATTATCACAGTTTTCG: TGATTATCACAGTTTTCGC
CTAATTTGCCTCCGTCGGA: TAATTTGCCTCCGTCGGAC
AAAAGATGATGCGTGAGTG: AAAGATGATGCGTGAGTGG
GCATTCAGGCATGCTGCGT: CATTCAGGCATGCTGCGTC
TGAGTCTTGTCGCACGCTT: GAGTCTTGTCGCACGCTTC
AGTACGCCTGTACTTGGGT: GTACGCCTGTACTTGGGTT
CAACAGAGTTTGGTCCTTT: AACAGAGTTTGGTCCTTTA
GCTTGCGTTCCAACAGAGT: CTTGCGTTCCAACAGAGTT
GGAGGCAGCGGGCCATTGA: GAGGCAGCGGGCCATTGAT
CTGTCACTAATTTGCCTCC: TGTCACTAATTTGCCTCCG
AGACGTACCCCTCCCCATC: GACGTACCCCTCCCCATCA
CTGCGTCGAATAACTTGTC: TGCGTCGAATAACTTGTCA
CCCGGGAGTTGTCACTCCA: CCGGGAGTTGTCACTCCAG
CTAGACCGATGGTTATGCA: TAGACCGATGGTTATGCAA
TTGCGGAAGTACGTTAAGC: TGCGGAAGTACGTTAAGCC
TAGGTCCGATATCTGTCTC: AGGTCCGATATCTGTCTCG
TCGACTCTTCTTTCGCAGC: CGACTCTTCTTTCGCAGCA
GACTCTTCTTTCGCAGCAC: ACTCTTCTTTCGCAGCACC
ACCCGGGTGACTAGTCTGT: CCCGGGTGACTAGTCTGTG
ATCATAGGGCGCGCTGGAC: TCATAGGGCGCGCTGGACC
TCACAGTCGCGGCTGTCAC: CACAGTCGCGGCTGTCACT
TCGAGTTATAGTGACGCTG: CGAGTTATAGTGACGCTGC
CACGTCAAAATTACCATAT: ACGTCAAAATTACCATATT
TGTCACGTCAAAATTACCA: GTCACGTCAAAATTACCAT
AGTTGCCACAAGGTGGGAG: GTTGCCACAAGGTGGGAGG
CACAGGCTAGGTCCGATAT: ACAGGCTAGGTCCGATATC
ACCTAAAAGACAATAACGA: CCTAAAAGACAATAACGAG
TCCGATAGCCGGAGTTGCC: CCGATAGCCGGAGTTGCCA
CGTATTAAGGTCCGATAGC: GTATTAAGGTCCGATAGCC
ACTCTACCGCTATCTCCGA: CTCTACCGCTATCTCCGAG
CGAAGTATTGCGCAGGGGC: GAAGTATTGCGCAGGGGCT
GCGATGTAGTTCCTCTCGA: CGATGTAGTTCCTCTCGAC
TCCGAGTGAATCCCGGAGT: CCGAGTGAATCCCGGAGTT
TCACCTATGAGACACTAGT: CACCTATGAGACACTAGTG
TATTAAGGTCCGATAGCCG: ATTAAGGTCCGATAGCCGG
CTCTTCACGAAGCCGTGAG: TCTTCACGAAGCCGTGAGC
TCCAGGCTTGAGGCCCTCC: CCAGGCTTGAGGCCCTCCT
TTGCGCAGGGGCTGGTAGT: TGCGCAGGGGCTGGTAGTC
CTTGCGGAAGTACGTTAAG: TTGCGGAAGTACGTTAAGC
GAAAGGAGATCCCACATAT: AAAGGAGATCCCACATATT
TCGTGTCGTCCCATAGCAT: CGTGTCGTCCCATAGCATG
GTGCCCAGGATATTAACTA: TGCCCAGGATATTAACTAA
GATGTAGTTCCTCTCGACT: ATGTAGTTCCTCTCGACTC
AGCGGCCGGGATTCTAATA: GCGGCCGGGATTCTAATAA
TTCTGGAGTTCCGGATGTT: TCTGGAGTTCCGGATGTTC
AATTTAGTACGCCTGTACT: ATTTAGTACGCCTGTACTT
GTGTCGTCCCATAGCATGG: TGTCGTCCCATAGCATGGT
TGCGCAGGGGCTGGTAGTC: GCGCAGGGGCTGGTAGTCA
ATTCGCTCCGTGTCTCCCT: TTCGCTCCGTGTCTCCCTA
GGCCTGGTTTTCACTTTAC: GCCTGGTTTTCACTTTACA
AATAATCATTGTGAGTCTT: ATAATCATTGTGAGTCTTG
CATGCTAAACCGGGATGGA: ATGCTAAACCGGGATGGAG
TGGTGTGCAAACACTCCCA: GGTGTGCAAACACTCCCAG
GTACGCCTGTACTTGGGTT: TACGCCTGTACTTGGGTTA
CGCTGCTCACCTATGAGAC: GCTGCTCACCTATGAGACA
CCTATGAGGGTTCCTTGAA: CTATGAGGGTTCCTTGAAT
CAACACCAGATTTCTATTG: AACACCAGATTTCTATTGG
TATGCAAACACTCCCAGTG: ATGCAAACACTCCCAGTGA
TTTATGAGTAACACTGTTC: TTATGAGTAACACTGTTCC
TGGGATCCCAGGCATGAGA: GGGATCCCAGGCATGAGAA
ACAGCAATCACAGGGGCAG: CAGCAATCACAGGGGCAGC
CTTTTGAGTCCTAAAGAAA: TTTTGAGTCCTAAAGAAAG
CAGGGGCAGCACAGTGATG: AGGGGCAGCACAGTGATGC
CAAGGGCCTGGTTTTCACT: AAGGGCCTGGTTTTCACTT
AAGGAGAGAGGTCTTATCG: AGGAGAGAGGTCTTATCGC
CCATATTCTGGAGTTCCGG: CATATTCTGGAGTTCCGGA
TTCTGGCGTTGGCCGTCCT: TCTGGCGTTGGCCGTCCTT
GAGACACTAGGCCCAGTGG: AGACACTAGGCCCAGTGGT
AGTGGTGTGCAAACACTCC: GTGGTGTGCAAACACTCCC
CGAGATATTGATCATTTCC: GAGATATTGATCATTTCCA
ATCCAGGCTTGAGGCCCTC: TCCAGGCTTGAGGCCCTCC
TGTCTGATAACCGGTGCTT: GTCTGATAACCGGTGCTTG
AGTAACACTGTTCCTTTGG: GTAACACTGTTCCTTTGGT
CCTCGCCCTCTTAATTAAT: CTCGCCCTCTTAATTAATC
ACCGGGATGGAGTATACTC: CCGGGATGGAGTATACTCT
TGTGCCCAGGATATTAACT: GTGCCCAGGATATTAACTA
ACCAAGTGACAATCTTAAT: CCAAGTGACAATCTTAATT
AATCTTTCATCCAGGCTTG: ATCTTTCATCCAGGCTTGA
CGTTCGAGTTATAGTGACG: GTTCGAGTTATAGTGACGC
TCTGGCGTTGGCCGTCCTT: CTGGCGTTGGCCGTCCTTT
AGGGCCTGGTTTTCACTTT: GGGCCTGGTTTTCACTTTA
TAATTTGCCTCCGTCGGAC: AATTTGCCTCCGTCGGACT
GAGAACCTCATTCTTTAGC: AGAACCTCATTCTTTAGCT
AGCCTGTTCGCGTTACTCC: GCCTGTTCGCGTTACTCCT
AAATTACCATATTCTGGAG: AATTACCATATTCTGGAGT
GTCCGAAAACAAAGGAGAG: TCCGAAAACAAAGGAGAGA
CAGTGATTTCTTCTCTTCA: AGTGATTTCTTCTCTTCAC
ATAACTTGTCACGTCAAAA: TAACTTGTCACGTCAAAAT
CAGCACAGTGATGCCGGCC: AGCACAGTGATGCCGGCCA
ATCCCACATATTTCACCTA: TCCCACATATTTCACCTAT
CCGGCGTCAGACCAGTCAG: CGGCGTCAGACCAGTCAGA
GGGTGACTAGTCTGTGCAA: GGTGACTAGTCTGTGCAAT
GCCATTGATACAGCTCAGG: CCATTGATACAGCTCAGGG
TTAGCTTAGCACACAGTGC: TAGCTTAGCACACAGTGCT
GCTCCGTGTCTCCCTATGA: CTCCGTGTCTCCCTATGAG
TGGATGATCGTTTTTACCC: GGATGATCGTTTTTACCCC
CAGGCCTCGCTTTTGAGTC: AGGCCTCGCTTTTGAGTCC
TAAATCCCCACAAGAGTCT: AAATCCCCACAAGAGTCTA
GAGTTGTCACTCCAGGGAC: AGTTGTCACTCCAGGGACA
AACACTCCCAGTGATTATC: ACACTCCCAGTGATTATCA
TCTGTCTCGGAACGCACCC: CTGTCTCGGAACGCACCCG
ACGCCTGTACTTGGGTTAT: CGCCTGTACTTGGGTTATT
GGATCCCAGGCATGAGAAC: GATCCCAGGCATGAGAACC
ACACTAGACCGATGGTTAT: CACTAGACCGATGGTTATG
GTCCTAAAGAAAGACGTAC: TCCTAAAGAAAGACGTACC
CTAGTCGTCCGAAAACAAA: TAGTCGTCCGAAAACAAAG
TCGTTAGGCGAGTACGGTA: CGTTAGGCGAGTACGGTAG
ACACTCCCAGTGATTTCTT: CACTCCCAGTGATTTCTTC
GAGGCCTGCGTGACCGATC: AGGCCTGCGTGACCGATCC
TGTGTGAACTTTGCAAACA: GTGTGAACTTTGCAAACAC
CCCAGGCATGAGAACCTCA: CCAGGCATGAGAACCTCAT
CTAAACCGGGATGGAGTAT: TAAACCGGGATGGAGTATA
GGCCGTAGCCCAAGCACGA: GCCGTAGCCCAAGCACGAC
TGCCATGTGTTGCGGGAGT: GCCATGTGTTGCGGGAGTG
GTTCCTCTCGACTCTTCTT: TTCCTCTCGACTCTTCTTT
TCGCGTTACTCCTGCGGCG: CGCGTTACTCCTGCGGCGA
AATTGCCATGTGTTGCGGG: ATTGCCATGTGTTGCGGGA
ATCCATAAATCCCCACAAG: TCCATAAATCCCCACAAGA
TTTATCAGAGAGGGGTAGT: TTATCAGAGAGGGGTAGTC
TCGTCACCGACTAAGCGGC: CGTCACCGACTAAGCGGCT
AGCTACTCGTGTCGTCCCA: GCTACTCGTGTCGTCCCAT
GTTATCCATTGCAAACACT: TTATCCATTGCAAACACTC
CATACTGAAAAATTTAGTA: ATACTGAAAAATTTAGTAC
TTCGCTCCGTGTCTCCCTA: TCGCTCCGTGTCTCCCTAT
CTTAGTGAAGTCCCGAGAT: TTAGTGAAGTCCCGAGATA
TTCGCAGCTACTCGTGTCG: TCGCAGCTACTCGTGTCGT
AGTGGTTCAGCATGCTAAA: GTGGTTCAGCATGCTAAAC
CCTGCGTGACCGATCCCGC: CTGCGTGACCGATCCCGCC
GTCTGATAACCGGTGCTTG: TCTGATAACCGGTGCTTGC
ACACATTGGGATCCCAGGC: CACATTGGGATCCCAGGCA
TGTTCGCGTTACTCCTGCG: GTTCGCGTTACTCCTGCGG
ATAACCGGTGCTTGCAAGG: TAACCGGTGCTTGCAAGGC
TATGAGACACTAGCAGTTA: ATGAGACACTAGCAGTTAT
CGGACCGAGTGGAGGCCTG: GGACCGAGTGGAGGCCTGC
CACACAGGCTAGGTCCGAT: ACACAGGCTAGGTCCGATA
GGAGTATACTCTTGCGGAA: GAGTATACTCTTGCGGAAG
TTGAATTGGGGGAGGCCGT: TGAATTGGGGGAGGCCGTA
CCCGCGAAACTGCATCTAC: CCGCGAAACTGCATCTACA
CATCTACACCGGTTTGGGC: ATCTACACCGGTTTGGGCC
AAATTTAGTACGCCTGTAC: AATTTAGTACGCCTGTACT
TACCAGCCATACTGAAAAA: ACCAGCCATACTGAAAAAT
AGGCTTGAGGCCCTCCTTT: GGCTTGAGGCCCTCCTTTA
AATAACTTGTCACGTCAAA: ATAACTTGTCACGTCAAAA
GGAGTTGGATTAGGTAGAT: GAGTTGGATTAGGTAGATC
TCACTCCAGGGACAGAAAG: CACTCCAGGGACAGAAAGG
CAAGGTGGGAGGCCAACCT: AAGGTGGGAGGCCAACCTT
TCCAGGGACAGAAAGGAGA: CCAGGGACAGAAAGGAGAT
GTTGATTGGCATAGCTTGT: TTGATTGGCATAGCTTGTG
GATTAGGTAGATCGGACTC: ATTAGGTAGATCGGACTCC
TCAGACCAGTCAGATAGGT: CAGACCAGTCAGATAGGTT
TCCAACAGCAATCACAGGG: CCAACAGCAATCACAGGGG
TGGTTATGCAAACACTCCC: GGTTATGCAAACACTCCCA
ACATATTTCACCTATGAGA: CATATTTCACCTATGAGAC
TAACACTGTTCCTTTGGTA: AACACTGTTCCTTTGGTAA
TGCCGCAACGCACCAAGTG: GCCGCAACGCACCAAGTGA
AGTTTCTCGTTCGAGTTAT: GTTTCTCGTTCGAGTTATA
AGGCCTCGCTTTTGAGTCC: GGCCTCGCTTTTGAGTCCT
ACGCAGTCGTTCTGATGCA: CGCAGTCGTTCTGATGCAC
ACCGCTATCTCCGAGTGAA: CCGCTATCTCCGAGTGAAT
AAGTCCCGAGATATTGATC: AGTCCCGAGATATTGATCA
GCACGCTTCTTGTGGACCT: CACGCTTCTTGTGGACCTA
CCAGGCATGAGAACCTCAT: CAGGCATGAGAACCTCATT
TAACTTGTCACGTCAAAAT: AACTTGTCACGTCAAAATT
ACAGCTCAGGGATAGCGCA: CAGCTCAGGGATAGCGCAC
CCACACAGGCTAGGTCCGA: CACACAGGCTAGGTCCGAT
AGCGGCTAGACGTTGACCC: GCGGCTAGACGTTGACCCC
TACTCCTGCGGCGATGTAG: ACTCCTGCGGCGATGTAGT
GCCCAAGCACGACTAGTCG: CCCAAGCACGACTAGTCGT
TACAGGCCTCGCTTTTGAG: ACAGGCCTCGCTTTTGAGT
CTTGCAACACCAGATTTCT: TTGCAACACCAGATTTCTA
ACTCAGTCGTCACCGACTA: CTCAGTCGTCACCGACTAA
GCAGGGGCTGGTAGTCAGG: CAGGGGCTGGTAGTCAGGT
CCTTTATCATAGGGCGCGC: CTTTATCATAGGGCGCGCT
GCATTTATTTCGCAGCTAC: CATTTATTTCGCAGCTACT
TAGATCTACATCACGGGCA: AGATCTACATCACGGGCAA
ATGGAGTATACTCTTGCGG: TGGAGTATACTCTTGCGGA
CAGACCTAGTGCCTACCTT: AGACCTAGTGCCTACCTTG
CTCCTGCGGCGATGTAGTT: TCCTGCGGCGATGTAGTTC
CGGCTGTCACTAATTTGCC: GGCTGTCACTAATTTGCCT
AGGGGTAGTCACGGTCTAG: GGGGTAGTCACGGTCTAGC
TTTCGCAGCACCGGCGTCA: TTCGCAGCACCGGCGTCAG
CGCACTCAGTCGTCACCGA: GCACTCAGTCGTCACCGAC
TATGTACCAATAATCATTG: ATGTACCAATAATCATTGT
TAGCTTAGCACACAGTGCT: AGCTTAGCACACAGTGCTC
CCCCATTCTTCTCTACCGC: CCCATTCTTCTCTACCGCG
CATTCTTTAGCTTAGCACA: ATTCTTTAGCTTAGCACAC
ATTGTGAGTCTTGTCGCAC: TTGTGAGTCTTGTCGCACG
CTAGTTTCTCGTTCGAGTT: TAGTTTCTCGTTCGAGTTA
CGCGGATCTATGTTGTTTC: GCGGATCTATGTTGTTTCA
TGCTCGTTAGGCGAGTACG: GCTCGTTAGGCGAGTACGG
TCTTCACGAAGCCGTGAGC: CTTCACGAAGCCGTGAGCG
TCGTCCCATAGCATGGTTA: CGTCCCATAGCATGGTTAG
ATTGCAAACACTCCCAGTG: TTGCAAACACTCCCAGTGA
TAGCATGGTTAGTCCTCGC: AGCATGGTTAGTCCTCGCC
TCTTGCGGAAGTACGTTAA: CTTGCGGAAGTACGTTAAG
GACGTTGACCCCATTCTAG: ACGTTGACCCCATTCTAGA
AAAGACAATAACGAGCTCA: AAGACAATAACGAGCTCAG
TAGACCGATGGTTATGCAA: AGACCGATGGTTATGCAAA
GACCTAGACGTGGCTGGGA: ACCTAGACGTGGCTGGGAT
TAGTCAGGTAAAGTGACGA: AGTCAGGTAAAGTGACGAG
ACCGGTGCTTGCAAGGCGA: CCGGTGCTTGCAAGGCGAA
TAAAATGGATGATCGTTTT: AAAATGGATGATCGTTTTT
TTCTCTACCGCGGATCTAT: TCTCTACCGCGGATCTATG
GGGAGGCCAACCTTCCCTG: GGAGGCCAACCTTCCCTGG
ATATTATTTTACAGGCCTC: TATTATTTTACAGGCCTCG
CCAGTCAGATAGGTTTTCT: CAGTCAGATAGGTTTTCTG
TACATCACGGGCAATATAG: ACATCACGGGCAATATAGG
GGGGTAGTCACGGTCTAGC: GGGTAGTCACGGTCTAGCG
CATCAGCGGACCGAGTGGA: ATCAGCGGACCGAGTGGAG
CACGAAGCCGTGAGCGAGA: ACGAAGCCGTGAGCGAGAC
TTATGTACCAATAATCATT: TATGTACCAATAATCATTG
TTGGTTAGATGGTTTGTAC: TGGTTAGATGGTTTGTACT
ACCTATGAGACACTAGCAG: CCTATGAGACACTAGCAGT
ATATAGGAAAGCTCCGTGC: TATAGGAAAGCTCCGTGCC
GGTTTGGGCCTGTCTGATA: GTTTGGGCCTGTCTGATAA
CCGAGGGTTCAGCGGATAG: CGAGGGTTCAGCGGATAGA
CAAGGCGAAGTATTGCGCA: AAGGCGAAGTATTGCGCAG
TTTCTATTGGTTGGCCTAA: TTCTATTGGTTGGCCTAAC
GGTGACTAGTCTGTGCAAT: GTGACTAGTCTGTGCAATC
CAGTCGTTCTGATGCACGA: AGTCGTTCTGATGCACGAT
CGTCGGACTAGTTTCTCGT: GTCGGACTAGTTTCTCGTT
CCCACAAGAGTCTAAAATG: CCACAAGAGTCTAAAATGG
TATGTTGTTTCAGGATTCC: ATGTTGTTTCAGGATTCCG
TCTATTGGTTGGCCTAACC: CTATTGGTTGGCCTAACCC
CCGAGATATTGATCATTTC: CGAGATATTGATCATTTCC
ATCTGTCTCGGAACGCACC: TCTGTCTCGGAACGCACCC
ATTGAGTCACCTATGAGAC: TTGAGTCACCTATGAGACA
AGGTCCGATAGCCGGAGTT: GGTCCGATAGCCGGAGTTG
TAGCAGTTATCCATTGCAA: AGCAGTTATCCATTGCAAA
AGCGAGACGCAGTCGTTCT: GCGAGACGCAGTCGTTCTG
TGGGAGGCCAACCTTCCCT: GGGAGGCCAACCTTCCCTG
CATTGATACAGCTCAGGGA: ATTGATACAGCTCAGGGAT
TGTCTCCCTATGAGGGTTC: GTCTCCCTATGAGGGTTCC
CTGCGGCGATGTAGTTCCT: TGCGGCGATGTAGTTCCTC
TCACGGGCAATATAGGAAA: CACGGGCAATATAGGAAAG
GACTAGTTTCTCGTTCGAG: ACTAGTTTCTCGTTCGAGT
CACTAGGCCCAGTGGTGTG: ACTAGGCCCAGTGGTGTGC
ACTCACACATTGGGATCCC: CTCACACATTGGGATCCCA
GCAATATAGGAAAGCTCCG: CAATATAGGAAAGCTCCGT
GGACAGAAAGGAGATCCCA: GACAGAAAGGAGATCCCAC
TGAACTCTACCGCTATCTC: GAACTCTACCGCTATCTCC
GCTCGTTAGGCGAGTACGG: CTCGTTAGGCGAGTACGGT
TTTCACCTATGAGACACTA: TTCACCTATGAGACACTAG
CCGGGATGGAGTATACTCT: CGGGATGGAGTATACTCTT
TATTATTTTACAGGCCTCG: ATTATTTTACAGGCCTCGC
TCATAGGGCGCGCTGGACC: CATAGGGCGCGCTGGACCT
ATTAAGGTCCGATAGCCGG: TTAAGGTCCGATAGCCGGA
CACATATTTCACCTATGAG: ACATATTTCACCTATGAGA
ACTCCTGCGGCGATGTAGT: CTCCTGCGGCGATGTAGTT
GCCCAGGATATTAACTAAA: CCCAGGATATTAACTAAAA
TCTAGATCTACATCACGGG: CTAGATCTACATCACGGGC
GAGACTCACACATTGGGAT: AGACTCACACATTGGGATC
CATTGCAAACACTCCCAGT: ATTGCAAACACTCCCAGTG
TTGCAAACACTCCCAGTGA: TGCAAACACTCCCAGTGAT TGCAAACACTCCCAGTGAT
CCACAAGAGTCTAAAATGG: CACAAGAGTCTAAAATGGA
TCACCTATGAGACACTAGA: CACCTATGAGACACTAGAC
TCACACATTGGGATCCCAG: CACACATTGGGATCCCAGG
TTCCCGGGCGCTGTGCCCA: TCCCGGGCGCTGTGCCCAG
CTATGAGACACTAGCAGTT: TATGAGACACTAGCAGTTA
CGATATCTGTCTCGGAACG: GATATCTGTCTCGGAACGC
GACCAGTCAGATAGGTTTT: ACCAGTCAGATAGGTTTTC
GATATTATTTTACAGGCCT: ATATTATTTTACAGGCCTC
GACGTGGCTGGGATGTGAA: ACGTGGCTGGGATGTGAAC
CCATAAATCCCCACAAGAG: CATAAATCCCCACAAGAGT
GGATGTGAACGATCGAGAA: GATGTGAACGATCGAGAAC
GAATAACTTGTCACGTCAA: AATAACTTGTCACGTCAAA
TAAAAAAACCCACACAGGC: AAAAAAACCCACACAGGCT
GAGTGGTTCAGCATGCTAA: AGTGGTTCAGCATGCTAAA
TCTCGACTCTTCTTTCGCA: CTCGACTCTTCTTTCGCAG
TTTACCCCATTCTTCTCTA: TTACCCCATTCTTCTCTAC
GTTTGGGCCTGTCTGATAA: TTTGGGCCTGTCTGATAAC
ATCACCCGCACCCGCGAAA: TCACCCGCACCCGCGAAAC
GATGCTCGTTAGGCGAGTA: ATGCTCGTTAGGCGAGTAC
AGAACCTCATTCTTTAGCT: GAACCTCATTCTTTAGCTT
TAGGTAGATCGGACTCCAG: AGGTAGATCGGACTCCAGG
TTCGCTTAGTGAAGTCCCG: TCGCTTAGTGAAGTCCCGA
CTAGGCCCAGTGGTGTGCA: TAGGCCCAGTGGTGTGCAA
TATCGCCGGGTTTATCAGA: ATCGCCGGGTTTATCAGAG
GACACTAGTGTGTGAACTT: ACACTAGTGTGTGAACTTT
GCGAAACTGCATCTACACC: CGAAACTGCATCTACACCG
CCGTCCTTTACCCCAGACC: CGTCCTTTACCCCAGACCT
GCCTCCGTCGGACTAGTTT: CCTCCGTCGGACTAGTTTC
CGAATAACTTGTCACGTCA: GAATAACTTGTCACGTCAA
ACCCCATTCTAGATCTACA: CCCCATTCTAGATCTACAT
AGAAATAATACCAGCCATA: GAAATAATACCAGCCATAC
CCTAACCCGAGGGTTCAGC: CTAACCCGAGGGTTCAGCG
CCTGCGGCGATGTAGTTCC: CTGCGGCGATGTAGTTCCT
CTATGTTGTTTCAGGATTC: TATGTTGTTTCAGGATTCC
CTATGAGGGTTCCTTGAAT: TATGAGGGTTCCTTGAATT
TTTTGAGTCCTAAAGAAAG: TTTGAGTCCTAAAGAAAGA
AACACTCCCAGTGATTTAT: ACACTCCCAGTGATTTATG
GGAGGCCAACCTTCCCTGG: GAGGCCAACCTTCCCTGGG
GACTAGTCTGTGCAATCTT: ACTAGTCTGTGCAATCTTT
ACAATAACGAGCTCAGTGC: CAATAACGAGCTCAGTGCC
GTGATTTATGTACCAATAA: TGATTTATGTACCAATAAT
GGGGAGGCCGTAGCCCAAG: GGGAGGCCGTAGCCCAAGC
ATTGGGGGAGGCCGTAGCC: TTGGGGGAGGCCGTAGCCC
CCCAAGCACGACTAGTCGT: CCAAGCACGACTAGTCGTC
TATCTGTCTCGGAACGCAC: ATCTGTCTCGGAACGCACC
ATGCCAAAGTTGATTGGCA: TGCCAAAGTTGATTGGCAT
AGTCCTAAAGAAAGACGTA: GTCCTAAAGAAAGACGTAC
CACATTGGGATCCCAGGCA: ACATTGGGATCCCAGGCAT
AGTACGGTAGGTTTATTTA: GTACGGTAGGTTTATTTAA
GAGATCCCACATATTTCAC: AGATCCCACATATTTCACC
ACGGGCAATATAGGAAAGC: CGGGCAATATAGGAAAGCT
GGCCATCCTTGATCAAGGG: GCCATCCTTGATCAAGGGC
TTAGCACACAGTGCTCATC: TAGCACACAGTGCTCATCA
GAGTTTGGTCCTTTATGAG: AGTTTGGTCCTTTATGAGT
AAGGCGAAGTATTGCGCAG: AGGCGAAGTATTGCGCAGG
TGGCTAGGAGACTCACACA: GGCTAGGAGACTCACACAT
ATTTTACAGGCCTCGCTTT: TTTTACAGGCCTCGCTTTT
TAATTAATCACAGTCGCGG: AATTAATCACAGTCGCGGC
CCGGTGCTTGCAAGGCGAA: CGGTGCTTGCAAGGCGAAG
CCTATGAGACACTAGACCG: CTATGAGACACTAGACCGA
ACATCATCACCCGCACCCG: CATCATCACCCGCACCCGC
GACCGATGGTTATGCAAAC: ACCGATGGTTATGCAAACA
TGCTTGCAAGGCGAAGTAT: GCTTGCAAGGCGAAGTATT
CTAGATCTACATCACGGGC: TAGATCTACATCACGGGCA
ACCCCTCCCCATCAGCGGA: CCCCTCCCCATCAGCGGAC
ATCATTGTGAGTCTTGTCG: TCATTGTGAGTCTTGTCGC
TGCCAAATTGCCATGTGTT: GCCAAATTGCCATGTGTTG
TATGAGGGTTCCTTGAATT: ATGAGGGTTCCTTGAATTG
GATTTATGTACCAATAATC: ATTTATGTACCAATAATCA
ATAGCTTGTGGCTAGGAGA: TAGCTTGTGGCTAGGAGAC
ATTAATCACAGTCGCGGCT: TTAATCACAGTCGCGGCTG
CCATAGCATGGTTAGTCCT: CATAGCATGGTTAGTCCTC
TATGAGACACTAGACCGAT: ATGAGACACTAGACCGATG
TCCAACAGAGTTTGGTCCT: CCAACAGAGTTTGGTCCTT
GAGTCTTGTCGCACGCTTC: AGTCTTGTCGCACGCTTCT
GATGGTTTGTACTCCTCGG: ATGGTTTGTACTCCTCGGA
AGTGACGAGAAATAATACC: GTGACGAGAAATAATACCA
GGATATTAACTAAAAAAAC: GATATTAACTAAAAAAACC
GCGCGCTGGACCTAGACGT: CGCGCTGGACCTAGACGTG
CAGTGATTTATGTACCAAT: AGTGATTTATGTACCAATA
TCCCCATCAGCGGACCGAG: CCCCATCAGCGGACCGAGT
CTTTGCAAACACTCCCAGT: TTTGCAAACACTCCCAGTG
CCCGCACCCGCGAAACTGC: CCGCACCCGCGAAACTGCA
GATCCCGCCAAGGACCTTA: ATCCCGCCAAGGACCTTAT
CACCGGTTTGGGCCTGTCT: ACCGGTTTGGGCCTGTCTG
CGTTCCAACAGAGTTTGGT: GTTCCAACAGAGTTTGGTC
CAAGCACGACTAGTCGTCC: AAGCACGACTAGTCGTCCG
TATAGTGACGCTGCTCACC: ATAGTGACGCTGCTCACCT
GTTCCGGATGTTCCCGGGC: TTCCGGATGTTCCCGGGCG
GCCATCCTTGATCAAGGGC: CCATCCTTGATCAAGGGCC
CCAGTGATTATCACAGTTT: CAGTGATTATCACAGTTTT
CCTTGATCAAGGGCCTGGT: CTTGATCAAGGGCCTGGTT
AATTACCATATTCTGGAGT: ATTACCATATTCTGGAGTT
GGAGACTCACACATTGGGA: GAGACTCACACATTGGGAT
ATCATCACCCGCACCCGCG: TCATCACCCGCACCCGCGA
CCCCACAAGAGTCTAAAAT: CCCACAAGAGTCTAAAATG
TTATCGCCGGGTTTATCAG: TATCGCCGGGTTTATCAGA
GATCGAGAACGCGTATTAA: ATCGAGAACGCGTATTAAG
TAGTGAAGTCCCGAGATAT: AGTGAAGTCCCGAGATATT
CAAACACTCCCAGTGATTT: AAACACTCCCAGTGATTTC AAACACTCCCAGTGATTTA
TTAGTCCTCGCCCTCTTAA: TAGTCCTCGCCCTCTTAAT
TAGGTTTATTTAATGCTAC: AGGTTTATTTAATGCTACC
CATGCTGCGTCGAATAACT: ATGCTGCGTCGAATAACTT
GCCTGTACTTGGGTTATTT: CCTGTACTTGGGTTATTTG
ATTTCTATTGGTTGGCCTA: TTTCTATTGGTTGGCCTAA
CTGTTCCTTTGGTAAAAGA: TGTTCCTTTGGTAAAAGAT
AGGCCCAGTGGTGTGCAAA: GGCCCAGTGGTGTGCAAAC
CTGGCGTTGGCCGTCCTTT: TGGCGTTGGCCGTCCTTTA
GTCGTCCCATAGCATGGTT: TCGTCCCATAGCATGGTTA
CCACATATTTCACCTATGA: CACATATTTCACCTATGAG
TACGTTAAGCCTGTTCGCG: ACGTTAAGCCTGTTCGCGT
TAGCGGCCGGGATTCTAAT: AGCGGCCGGGATTCTAATA
AGGCCTGCGTGACCGATCC: GGCCTGCGTGACCGATCCC
ATCGTTTTTACCCCATTCT: TCGTTTTTACCCCATTCTT
GCGGAAGTACGTTAAGCCT: CGGAAGTACGTTAAGCCTG
AACCTTCCCTGGGCGAGAC: ACCTTCCCTGGGCGAGACG
GGAACGCACCCGATACCTT: GAACGCACCCGATACCTTT
CCGAAAACAAAGGAGAGAG: CGAAAACAAAGGAGAGAGG
CAATGTCCAGCATTCAGGC: AATGTCCAGCATTCAGGCA
GTGCCGCAACGCACCAAGT: TGCCGCAACGCACCAAGTG
GATTCTAATAAGACAATGT: ATTCTAATAAGACAATGTC
AGTGATGATATTATTTTAC: GTGATGATATTATTTTACA
CGAGAAATAATACCAGCCA: GAGAAATAATACCAGCCAT
TATGAGACACTAGTGTGTG: ATGAGACACTAGTGTGTGA
CCATCAGCGGACCGAGTGG: CATCAGCGGACCGAGTGGA
TATCATAGGGCGCGCTGGA: ATCATAGGGCGCGCTGGAC
GTGATGATATTATTTTACA: TGATGATATTATTTTACAG
GGCCTAACCCGAGGGTTCA: GCCTAACCCGAGGGTTCAG
GTCTGTGCAATCTTTCATC: TCTGTGCAATCTTTCATCC
TAGACGTTGACCCCATTCT: AGACGTTGACCCCATTCTA
ACGCTTCTTGTGGACCTAA: CGCTTCTTGTGGACCTAAA
GCGAAGTATTGCGCAGGGG: CGAAGTATTGCGCAGGGGC
CGGCGTCAGACCAGTCAGA: GGCGTCAGACCAGTCAGAT
TTTTCGCATTTATTTCGCA: TTTCGCATTTATTTCGCAG
CGCGTATTAAGGTCCGATA: GCGTATTAAGGTCCGATAG
CATTGGGATCCCAGGCATG: ATTGGGATCCCAGGCATGA
CATATTCTGGAGTTCCGGA: ATATTCTGGAGTTCCGGAT
TCTCTTCACGAAGCCGTGA: CTCTTCACGAAGCCGTGAG
TTTGGTAAAAGATGATGCG: TTGGTAAAAGATGATGCGT
TGTTGTTTCAGGATTCCGT: GTTGTTTCAGGATTCCGTG
AGCGGGCCATTGATACAGC: GCGGGCCATTGATACAGCT
CTGGACCTAGACGTGGCTG: TGGACCTAGACGTGGCTGG
TAGTTCCTCTCGACTCTTC: AGTTCCTCTCGACTCTTCT
TCAGGATTCCGTGCCATAG: CAGGATTCCGTGCCATAGG
GGAGGCCTGCGTGACCGAT: GAGGCCTGCGTGACCGATC
TTGGTTGGCCTAACCCGAG: TGGTTGGCCTAACCCGAGG
GATATTGATCATTTCCAAC: ATATTGATCATTTCCAACA
ACCTATGAGACACTAGACC: CCTATGAGACACTAGACCG
CCGATGGTTATGCAAACAC: CGATGGTTATGCAAACACT
AAGCACGACTAGTCGTCCG: AGCACGACTAGTCGTCCGA
GTCCAGCATTCAGGCATGC: TCCAGCATTCAGGCATGCT
GTCGCGGCTGTCACTAATT: TCGCGGCTGTCACTAATTT
ACGTGGCTGGGATGTGAAC: CGTGGCTGGGATGTGAACG
ATTGGCATAGCTTGTGGCT: TTGGCATAGCTTGTGGCTA
CGAAAACAAAGGAGAGAGG: GAAAACAAAGGAGAGAGGT
TTATCCATTGCAAACACTC: TATCCATTGCAAACACTCC
ATGGTTAGTCCTCGCCCTC: TGGTTAGTCCTCGCCCTCT
CCGGAGTTGGATTAGGTAG: CGGAGTTGGATTAGGTAGA
CCTGTTCGCGTTACTCCTG: CTGTTCGCGTTACTCCTGC
CGGGTTTATCAGAGAGGGG: GGGTTTATCAGAGAGGGGT
CACACATTGGGATCCCAGG: ACACATTGGGATCCCAGGC
CCAACCTTCCCTGGGCGAG: CAACCTTCCCTGGGCGAGA
TGGACCTAGACGTGGCTGG: GGACCTAGACGTGGCTGGG
GTGTGCAAACACTCCCAGT: TGTGCAAACACTCCCAGTG
AGGATATTAACTAAAAAAA: GGATATTAACTAAAAAAAC
CGAGTACGGTAGGTTTATT: GAGTACGGTAGGTTTATTT
CCTTATCACCTATGAGACA: CTTATCACCTATGAGACAC
CAGTGATTATCACAGTTTT: AGTGATTATCACAGTTTTC
CTAGCAGTTATCCATTGCA: TAGCAGTTATCCATTGCAA
GAAGTACGTTAAGCCTGTT: AAGTACGTTAAGCCTGTTC
AGGGACAGAAAGGAGATCC: GGGACAGAAAGGAGATCCC
TGCCATAGGAAACACCCGG: GCCATAGGAAACACCCGGG
GCGGCTGTCACTAATTTGC: CGGCTGTCACTAATTTGCC
GCAAACACTCCCAGTGATT: CAAACACTCCCAGTGATTA CAAACACTCCCAGTGATTT CAAACACTCCCAGTGATTT
GATGCCAAAGTTGATTGGC: ATGCCAAAGTTGATTGGCA
GTTGGCCGTCCTTTACCCC: TTGGCCGTCCTTTACCCCA
AGTGCCGCAACGCACCAAG: GTGCCGCAACGCACCAAGT
CCGTGCCATAGGAAACACC: CGTGCCATAGGAAACACCC
TGGGATGTGAACGATCGAG: GGGATGTGAACGATCGAGA
CCGCCAAGGACCTTATCAC: CGCCAAGGACCTTATCACC
ACCGCGGATCTATGTTGTT: CCGCGGATCTATGTTGTTT
CAGGTAAAGTGACGAGAAA: AGGTAAAGTGACGAGAAAT
CAGTGCTCATCATCCATAA: AGTGCTCATCATCCATAAA
ACCGGCGTCAGACCAGTCA: CCGGCGTCAGACCAGTCAG
GAGTTATAGTGACGCTGCT: AGTTATAGTGACGCTGCTC
AATATAGGAAAGCTCCGTG: ATATAGGAAAGCTCCGTGC
AAAATGGATGATCGTTTTT: AAATGGATGATCGTTTTTA
CTTGCGTTCCAACAGAGTT: TTGCGTTCCAACAGAGTTT
AAACACCCGGGTGACTAGT: AACACCCGGGTGACTAGTC
ACTCCAGGCTTGCGTTCCA: CTCCAGGCTTGCGTTCCAA
GTCCGATATCTGTCTCGGA: TCCGATATCTGTCTCGGAA
GCAGCGGGCCATTGATACA: CAGCGGGCCATTGATACAG
GTGATGCCGGCCATCCTTG: TGATGCCGGCCATCCTTGA
CCAGGGACAGAAAGGAGAT: CAGGGACAGAAAGGAGATC
TAAAGAAAGACGTACCCCT: AAAGAAAGACGTACCCCTC
CCAGGCTTGAGGCCCTCCT: CAGGCTTGAGGCCCTCCTT
TGCGTGACCGATCCCGCCA: GCGTGACCGATCCCGCCAA
TGGGTTATTTGGGTAATTG: GGGTTATTTGGGTAATTGA
CGGAGTTGCCACAAGGTGG: GGAGTTGCCACAAGGTGGG
ATCTTAATTCGCTCCGTGT: TCTTAATTCGCTCCGTGTC
ACAGTGCTCATCATCCATA: CAGTGCTCATCATCCATAA
AAGCCGTGAGCGAGACGCA: AGCCGTGAGCGAGACGCAG
TCTACCGCGGATCTATGTT: CTACCGCGGATCTATGTTG
TAGTCTGTGCAATCTTTCA: AGTCTGTGCAATCTTTCAT
CACCAGATTTCTATTGGTT: ACCAGATTTCTATTGGTTG
CAGGCTAGGTCCGATATCT: AGGCTAGGTCCGATATCTG
CCCTCTTAATTAATCACAG: CCTCTTAATTAATCACAGT
GCTTGCAAGGCGAAGTATT: CTTGCAAGGCGAAGTATTG
TCTCCGAGTGAATCCCGGA: CTCCGAGTGAATCCCGGAG
ACCGAGTGGAGGCCTGCGT: CCGAGTGGAGGCCTGCGTG
ACACTCCCAGTGATTTATG: CACTCCCAGTGATTTATGT
GTCGCACGCTTCTTGTGGA: TCGCACGCTTCTTGTGGAC
TTCTAGATCTACATCACGG: TCTAGATCTACATCACGGG
GAGTTGCCACAAGGTGGGA: AGTTGCCACAAGGTGGGAG
ACAGAGTTTGGTCCTTTAT: CAGAGTTTGGTCCTTTATG
CGCCAAGGACCTTATCACC: GCCAAGGACCTTATCACCT
CCCGAGGGTTCAGCGGATA: CCGAGGGTTCAGCGGATAG
CTTAGCACACAGTGCTCAT: TTAGCACACAGTGCTCATC
AAAATTTAGTACGCCTGTA: AAATTTAGTACGCCTGTAC
CGGAACGCACCCGATACCT: GGAACGCACCCGATACCTT
TGACGAGAAATAATACCAG: GACGAGAAATAATACCAGC
AATTCGCTCCGTGTCTCCC: ATTCGCTCCGTGTCTCCCT
GAGTTGGATTAGGTAGATC: AGTTGGATTAGGTAGATCG
GATTTCTATTGGTTGGCCT: ATTTCTATTGGTTGGCCTA
AGGCTTGCGTTCCAACAGA: GGCTTGCGTTCCAACAGAG
ACCCCCGTGTCTTCGCTTA: CCCCCGTGTCTTCGCTTAG
GCGTCAGACCAGTCAGATA: CGTCAGACCAGTCAGATAG
CGCAGCTACTCGTGTCGTC: GCAGCTACTCGTGTCGTCC
ACCTAGACGTGGCTGGGAT: CCTAGACGTGGCTGGGATG
TATTGCGCAGGGGCTGGTA: ATTGCGCAGGGGCTGGTAG
TAGTTTCTCGTTCGAGTTA: AGTTTCTCGTTCGAGTTAT
AAAATTACCATATTCTGGA: AAATTACCATATTCTGGAG
ATTTCACCGGGCACATCAT: TTTCACCGGGCACATCATC
CTGATAACCGGTGCTTGCA: TGATAACCGGTGCTTGCAA
TCGGACTCCAGGCTTGCGT: CGGACTCCAGGCTTGCGTT
AAATAATACCAGCCATACT: AATAATACCAGCCATACTG
TGACCCGGGAGTTGTCACT: GACCCGGGAGTTGTCACTC
ATCACAGTTTTCGCATTTA: TCACAGTTTTCGCATTTAT
TGTCTCGGAACGCACCCGA: GTCTCGGAACGCACCCGAT
AAGACAATGTCCAGCATTC: AGACAATGTCCAGCATTCA
GTGCTCATCATCCATAAAT: TGCTCATCATCCATAAATC
TTGTGGACCTAAAAGACAA: TGTGGACCTAAAAGACAAT
TGAGTCACCTATGAGACAC: GAGTCACCTATGAGACACT
GACGCTGCTCACCTATGAG: ACGCTGCTCACCTATGAGA
AGGATTCCGTGCCATAGGA: GGATTCCGTGCCATAGGAA
AGACGTGGCTGGGATGTGA: GACGTGGCTGGGATGTGAA
CGCGGCTGTCACTAATTTG: GCGGCTGTCACTAATTTGC
CCAGGATATTAACTAAAAA: CAGGATATTAACTAAAAAA
TCCTCGGAGGCAGCGGGCC: CCTCGGAGGCAGCGGGCCA
AAACCCACACAGGCTAGGT: AACCCACACAGGCTAGGTC
TCCTTGATCAAGGGCCTGG: CCTTGATCAAGGGCCTGGT
CCTTTATGAGTAACACTGT: CTTTATGAGTAACACTGTT
ACAGGCCTCGCTTTTGAGT: CAGGCCTCGCTTTTGAGTC
GCGTCGAATAACTTGTCAC: CGTCGAATAACTTGTCACG
TCTTAATTAATCACAGTCG: CTTAATTAATCACAGTCGC
TCGCTTAGTGAAGTCCCGA: CGCTTAGTGAAGTCCCGAG
GCAGCTACTCGTGTCGTCC: CAGCTACTCGTGTCGTCCC
CAGAGAGGGGTAGTCACGG: AGAGAGGGGTAGTCACGGT
GTCCTCGCCCTCTTAATTA: TCCTCGCCCTCTTAATTAA
TTCACGAAGCCGTGAGCGA: TCACGAAGCCGTGAGCGAG
GGATGGAGTATACTCTTGC: GATGGAGTATACTCTTGCG
TAGACGTGGCTGGGATGTG: AGACGTGGCTGGGATGTGA
CGAAACTGCATCTACACCG: GAAACTGCATCTACACCGG
AGCTCCGTGCCAAATTGCC: GCTCCGTGCCAAATTGCCA
CTTTCATCCAGGCTTGAGG: TTTCATCCAGGCTTGAGGC
TTGAACTCTACCGCTATCT: TGAACTCTACCGCTATCTC
TTCTCTTCACGAAGCCGTG: TCTCTTCACGAAGCCGTGA
AATCCCGGAGTTGGATTAG: ATCCCGGAGTTGGATTAGG
GACAATAACGAGCTCAGTG: ACAATAACGAGCTCAGTGC
AGTATTGCGCAGGGGCTGG: GTATTGCGCAGGGGCTGGT
GGACTCCAGGCTTGCGTTC: GACTCCAGGCTTGCGTTCC
CTTCTTGTGGACCTAAAAG: TTCTTGTGGACCTAAAAGA
GGCGTCAGACCAGTCAGAT: GCGTCAGACCAGTCAGATA
ATGAGTAACACTGTTCCTT: TGAGTAACACTGTTCCTTT
GGGGCTGGTAGTCAGGTAA: GGGCTGGTAGTCAGGTAAA
GGGTTCAGCGGATAGATGC: GGTTCAGCGGATAGATGCC
GAATTGGGGGAGGCCGTAG: AATTGGGGGAGGCCGTAGC
CATGTGTTGCGGGAGTGAC: ATGTGTTGCGGGAGTGACC
GCTTAGCACACAGTGCTCA: CTTAGCACACAGTGCTCAT
CTGTCTGATAACCGGTGCT: TGTCTGATAACCGGTGCTT
CCTTTACCCCAGACCTAGT: CTTTACCCCAGACCTAGTG
GGGCTGGTAGTCAGGTAAA: GGCTGGTAGTCAGGTAAAG
GATACAGCTCAGGGATAGC: ATACAGCTCAGGGATAGCG
GCAATCTTTCATCCAGGCT: CAATCTTTCATCCAGGCTT
GAACGCACCCGATACCTTT: AACGCACCCGATACCTTTG
GTGAACGATCGAGAACGCG: TGAACGATCGAGAACGCGT
CGTGCCATAGGAAACACCC: GTGCCATAGGAAACACCCG
CGTGAGCGAGACGCAGTCG: GTGAGCGAGACGCAGTCGT
GACAGAAAGGAGATCCCAC: ACAGAAAGGAGATCCCACA
TTTGCAAACACTCCCAGTG: TTGCAAACACTCCCAGTGA
GTAGTCAGGTAAAGTGACG: TAGTCAGGTAAAGTGACGA
CCGATACCTTTGGTTAGAT: CGATACCTTTGGTTAGATG
TTTCGCAGCTACTCGTGTC: TTCGCAGCTACTCGTGTCG
TCTGTGCAATCTTTCATCC: CTGTGCAATCTTTCATCCA
GTACTTGGGTTATTTGGGT: TACTTGGGTTATTTGGGTA
CAGTCGTCACCGACTAAGC: AGTCGTCACCGACTAAGCG
AGTGATTTATGTACCAATA: GTGATTTATGTACCAATAA
GGGTTTATCAGAGAGGGGT: GGTTTATCAGAGAGGGGTA
CGTCGAATAACTTGTCACG: GTCGAATAACTTGTCACGT
GTCGTCACCGACTAAGCGG: TCGTCACCGACTAAGCGGC
GTCTAGCGGCCGGGATTCT: TCTAGCGGCCGGGATTCTA
CGAGAACGCGTATTAAGGT: GAGAACGCGTATTAAGGTC
GTTATAGTGACGCTGCTCA: TTATAGTGACGCTGCTCAC
TAGGGCGCGCTGGACCTAG: AGGGCGCGCTGGACCTAGA
ACGATGCTCGTTAGGCGAG: CGATGCTCGTTAGGCGAGT
GATTGGCATAGCTTGTGGC: ATTGGCATAGCTTGTGGCT
CTATGAGACACTAGGCCCA: TATGAGACACTAGGCCCAG
TATAGGAAAGCTCCGTGCC: ATAGGAAAGCTCCGTGCCA
CATTCTAGATCTACATCAC: ATTCTAGATCTACATCACG
CTACATCACGGGCAATATA: TACATCACGGGCAATATAG
CTATGAGACACTAGACCGA: TATGAGACACTAGACCGAT
AGGAGATCCCACATATTTC: GGAGATCCCACATATTTCA
CTTTCGCAGCACCGGCGTC: TTTCGCAGCACCGGCGTCA
CGGTCTAGCGGCCGGGATT: GGTCTAGCGGCCGGGATTC
TTCTATTTCACCGGGCACA: TCTATTTCACCGGGCACAT
ATTTATTTCGCAGCTACTC: TTTATTTCGCAGCTACTCG
ACAAAGGAGAGAGGTCTTA: CAAAGGAGAGAGGTCTTAT
GTATACTCTTGCGGAAGTA: TATACTCTTGCGGAAGTAC
TGCTACCCCCGTGTCTTCG: GCTACCCCCGTGTCTTCGC
TAAAAGATGATGCGTGAGT: AAAAGATGATGCGTGAGTG
AGGCCAACCTTCCCTGGGC: GGCCAACCTTCCCTGGGCG
CAACCTTCCCTGGGCGAGA: AACCTTCCCTGGGCGAGAC
TTAGGTAGATCGGACTCCA: TAGGTAGATCGGACTCCAG
AGGGATAGCGCACTCAGTC: GGGATAGCGCACTCAGTCG
CCCAGTGATTATCACAGTT: CCAGTGATTATCACAGTTT
GCGCTGTGCCCAGGATATT: CGCTGTGCCCAGGATATTA
GCGGGAGTGACCCGGGAGT: CGGGAGTGACCCGGGAGTT
AGACACTAGCAGTTATCCA: GACACTAGCAGTTATCCAT
AAGGAGATCCCACATATTT: AGGAGATCCCACATATTTC
GATCCCACATATTTCACCT: ATCCCACATATTTCACCTA
GCCTCGCTTTTGAGTCCTA: CCTCGCTTTTGAGTCCTAA
GGATCTATGTTGTTTCAGG: GATCTATGTTGTTTCAGGA
TGCTAAACCGGGATGGAGT: GCTAAACCGGGATGGAGTA
CTCCTCGGAGGCAGCGGGC: TCCTCGGAGGCAGCGGGCC
TCGCATTTATTTCGCAGCT: CGCATTTATTTCGCAGCTA
AAATTGCCATGTGTTGCGG: AATTGCCATGTGTTGCGGG
CCAATAATCATTGTGAGTC: CAATAATCATTGTGAGTCT
CGTCCCATAGCATGGTTAG: GTCCCATAGCATGGTTAGT
CACCGGCGTCAGACCAGTC: ACCGGCGTCAGACCAGTCA
GGTTAGTCCTCGCCCTCTT: GTTAGTCCTCGCCCTCTTA
TCAGCATGCTAAACCGGGA: CAGCATGCTAAACCGGGAT
ACCCGAGGGTTCAGCGGAT: CCCGAGGGTTCAGCGGATA
AGTGACCCGGGAGTTGTCA: GTGACCCGGGAGTTGTCAC
GAGGGTTCCTTGAATTGGG: AGGGTTCCTTGAATTGGGG
TTTATCATAGGGCGCGCTG: TTATCATAGGGCGCGCTGG
ATAGGAAACACCCGGGTGA: TAGGAAACACCCGGGTGAC
CTCTTGCGGAAGTACGTTA: TCTTGCGGAAGTACGTTAA
TAATTGAGTCACCTATGAG: AATTGAGTCACCTATGAGA
AACTCTACCGCTATCTCCG: ACTCTACCGCTATCTCCGA
CGGCCGGGATTCTAATAAG: GGCCGGGATTCTAATAAGA
TCGTTCGAGTTATAGTGAC: CGTTCGAGTTATAGTGACG
AACGATCGAGAACGCGTAT: ACGATCGAGAACGCGTATT
CTGCTCACCTATGAGACAC: TGCTCACCTATGAGACACT
AAGGACCTTATCACCTATG: AGGACCTTATCACCTATGA
AGGTGGGAGGCCAACCTTC: GGTGGGAGGCCAACCTTCC
GTTCTATTTCACCGGGCAC: TTCTATTTCACCGGGCACA
TGAATTGGGGGAGGCCGTA: GAATTGGGGGAGGCCGTAG
GGATGATCGTTTTTACCCC: GATGATCGTTTTTACCCCA
CCCGAGATATTGATCATTT: CCGAGATATTGATCATTTC
TTTCAGGATTCCGTGCCAT: TTCAGGATTCCGTGCCATA
CGTGTCGTCCCATAGCATG: GTGTCGTCCCATAGCATGG
TACTCGTGTCGTCCCATAG: ACTCGTGTCGTCCCATAGC
AAAACAAAGGAGAGAGGTC: AAACAAAGGAGAGAGGTCT
ACTTGTCACGTCAAAATTA: CTTGTCACGTCAAAATTAC
TTTCTGGCGTTGGCCGTCC: TTCTGGCGTTGGCCGTCCT
CGACTAAGCGGCTAGACGT: GACTAAGCGGCTAGACGTT
AGATCGGACTCCAGGCTTG: GATCGGACTCCAGGCTTGC
GTCTTATCGCCGGGTTTAT: TCTTATCGCCGGGTTTATC
TTCTAATAAGACAATGTCC: TCTAATAAGACAATGTCCA
GTTGACCCCATTCTAGATC: TTGACCCCATTCTAGATCT
ACACTCCCAGTGATGATAT: CACTCCCAGTGATGATATT
ACCGGTTTGGGCCTGTCTG: CCGGTTTGGGCCTGTCTGA
TCCCGAGATATTGATCATT: CCCGAGATATTGATCATTT
TCTCGGAACGCACCCGATA: CTCGGAACGCACCCGATAC
GAAACACCCGGGTGACTAG: AAACACCCGGGTGACTAGT
TTTGCCTCCGTCGGACTAG: TTGCCTCCGTCGGACTAGT
TCGCAGCTACTCGTGTCGT: CGCAGCTACTCGTGTCGTC
GAGGGTTCAGCGGATAGAT: AGGGTTCAGCGGATAGATG
AAACACTCCCAGTGATGAT: AACACTCCCAGTGATGATA
GAGAAATAATACCAGCCAT: AGAAATAATACCAGCCATA
CCTGTACTTGGGTTATTTG: CTGTACTTGGGTTATTTGG
GGTAGGTTTATTTAATGCT: GTAGGTTTATTTAATGCTA
CCCGATACCTTTGGTTAGA: CCGATACCTTTGGTTAGAT
TAATGCTACCCCCGTGTCT: AATGCTACCCCCGTGTCTT
GGGGGAGGCCGTAGCCCAA: GGGGAGGCCGTAGCCCAAG
ACGTTGACCCCATTCTAGA: CGTTGACCCCATTCTAGAT
TCGGAGGCAGCGGGCCATT: CGGAGGCAGCGGGCCATTG
TAGTGTGTGAACTTTGCAA: AGTGTGTGAACTTTGCAAA
GCCGGGATTCTAATAAGAC: CCGGGATTCTAATAAGACA
TACCATATTCTGGAGTTCC: ACCATATTCTGGAGTTCCG
TTTATGTACCAATAATCAT: TTATGTACCAATAATCATT
TTACCCCATTCTTCTCTAC: TACCCCATTCTTCTCTACC
TGATTATCACAGTTTTCGC: GATTATCACAGTTTTCGCA
AGTCTTGTCGCACGCTTCT: GTCTTGTCGCACGCTTCTT
ACGTCAAAATTACCATATT: CGTCAAAATTACCATATTC
AGAAAGACGTACCCCTCCC: GAAAGACGTACCCCTCCCC
TTACCCCAGACCTAGTGCC: TACCCCAGACCTAGTGCCT
ACCTTCCCTGGGCGAGACG: CCTTCCCTGGGCGAGACGT
TGAGTGGTTCAGCATGCTA: GAGTGGTTCAGCATGCTAA
CGTCCGAAAACAAAGGAGA: GTCCGAAAACAAAGGAGAG
CTACACCGGTTTGGGCCTG: TACACCGGTTTGGGCCTGT
TTGATACAGCTCAGGGATA: TGATACAGCTCAGGGATAG
TTCGCAGCACCGGCGTCAG: TCGCAGCACCGGCGTCAGA
ACTAGCAGTTATCCATTGC: CTAGCAGTTATCCATTGCA
TAACGAGCTCAGTGCCGCA: AACGAGCTCAGTGCCGCAA
CTCTTCTTTCGCAGCACCG: TCTTCTTTCGCAGCACCGG
TTAGATGGTTTGTACTCCT: TAGATGGTTTGTACTCCTC
CGATAGCCGGAGTTGCCAC: GATAGCCGGAGTTGCCACA
GTAAAGTGACGAGAAATAA: TAAAGTGACGAGAAATAAT
GATCGTTTTTACCCCATTC: ATCGTTTTTACCCCATTCT
CCGTGAGCGAGACGCAGTC: CGTGAGCGAGACGCAGTCG
TGTTCCCGGGCGCTGTGCC: GTTCCCGGGCGCTGTGCCC
CGCAGTCGTTCTGATGCAC: GCAGTCGTTCTGATGCACG
CTCGTTAGGCGAGTACGGT: TCGTTAGGCGAGTACGGTA
GTGCTTGCAAGGCGAAGTA: TGCTTGCAAGGCGAAGTAT
CCGTGTCTTCGCTTAGTGA: CGTGTCTTCGCTTAGTGAA
TATTTGGGTAATTGAGTCA: ATTTGGGTAATTGAGTCAC
GTTAGGCGAGTACGGTAGG: TTAGGCGAGTACGGTAGGT
CGGATAGATGCCAAAGTTG: GGATAGATGCCAAAGTTGA
CTCGACTCTTCTTTCGCAG: TCGACTCTTCTTTCGCAGC
TTTCCAACAGCAATCACAG: TTCCAACAGCAATCACAGG
GTGGTTCAGCATGCTAAAC: TGGTTCAGCATGCTAAACC
TCATTTCCAACAGCAATCA: CATTTCCAACAGCAATCAC
CGCACCAAGTGACAATCTT: GCACCAAGTGACAATCTTA
AGTCGCGGCTGTCACTAAT: GTCGCGGCTGTCACTAATT
GGAAACACCCGGGTGACTA: GAAACACCCGGGTGACTAG
TACTTGGGTTATTTGGGTA: ACTTGGGTTATTTGGGTAA
GTCCTTTACCCCAGACCTA: TCCTTTACCCCAGACCTAG
TGAGAACCTCATTCTTTAG: GAGAACCTCATTCTTTAGC
GCACAGTGATGCCGGCCAT: CACAGTGATGCCGGCCATC
ACCAGATTTCTATTGGTTG: CCAGATTTCTATTGGTTGG
TGCAAGGCGAAGTATTGCG: GCAAGGCGAAGTATTGCGC
TTCAGCGGATAGATGCCAA: TCAGCGGATAGATGCCAAA
TGAGGCCCTCCTTTATCAT: GAGGCCCTCCTTTATCATA
CGATACCTTTGGTTAGATG: GATACCTTTGGTTAGATGG
CTATTGGTTGGCCTAACCC: TATTGGTTGGCCTAACCCG
GTTCAGCATGCTAAACCGG: TTCAGCATGCTAAACCGGG
ATGATATTATTTTACAGGC: TGATATTATTTTACAGGCC
GCGGATAGATGCCAAAGTT: CGGATAGATGCCAAAGTTG
CATAGGAAACACCCGGGTG: ATAGGAAACACCCGGGTGA
CAAATTGCCATGTGTTGCG: AAATTGCCATGTGTTGCGG
AAAGACGTACCCCTCCCCA: AAGACGTACCCCTCCCCAT
GGCATGAGAACCTCATTCT: GCATGAGAACCTCATTCTT
TTGGCCGTCCTTTACCCCA: TGGCCGTCCTTTACCCCAG
TTGTCACGTCAAAATTACC: TGTCACGTCAAAATTACCA
GCTGGTAGTCAGGTAAAGT: CTGGTAGTCAGGTAAAGTG
CGGGCCATTGATACAGCTC: GGGCCATTGATACAGCTCA
ACCTAGTGCCTACCTTGCA: CCTAGTGCCTACCTTGCAA
CTATGAGACACTAGTGTGT: TATGAGACACTAGTGTGTG
TGAGCGAGACGCAGTCGTT: GAGCGAGACGCAGTCGTTC
CTAGACGTGGCTGGGATGT: TAGACGTGGCTGGGATGTG
TAGATCGGACTCCAGGCTT: AGATCGGACTCCAGGCTTG
GTCTCGGAACGCACCCGAT: TCTCGGAACGCACCCGATA
CACCCGCACCCGCGAAACT: ACCCGCACCCGCGAAACTG
CCGCTATCTCCGAGTGAAT: CGCTATCTCCGAGTGAATC
GGGATGTGAACGATCGAGA: GGATGTGAACGATCGAGAA
TAAACCGGGATGGAGTATA: AAACCGGGATGGAGTATAC
CCCTGGGCGAGACGTTCTA: CCTGGGCGAGACGTTCTAT
GTCACTAATTTGCCTCCGT: TCACTAATTTGCCTCCGTC
AGCGCACTCAGTCGTCACC: GCGCACTCAGTCGTCACCG
CAGTGATGCCGGCCATCCT: AGTGATGCCGGCCATCCTT
TGAACTTTGCAAACACTCC: GAACTTTGCAAACACTCCC
AGTCAGGTAAAGTGACGAG: GTCAGGTAAAGTGACGAGA
CCTCCCCATCAGCGGACCG: CTCCCCATCAGCGGACCGA
TACGGTAGGTTTATTTAAT: ACGGTAGGTTTATTTAATG
CAATAATCATTGTGAGTCT: AATAATCATTGTGAGTCTT
GTCGAATAACTTGTCACGT: TCGAATAACTTGTCACGTC
GCGCAGGGGCTGGTAGTCA: CGCAGGGGCTGGTAGTCAG
GTTCGCGTTACTCCTGCGG: TTCGCGTTACTCCTGCGGC
GATGGAGTATACTCTTGCG: ATGGAGTATACTCTTGCGG
TTAATTAATCACAGTCGCG: TAATTAATCACAGTCGCGG
CCCAGTGGTGTGCAAACAC: CCAGTGGTGTGCAAACACT
TAACCGGTGCTTGCAAGGC: AACCGGTGCTTGCAAGGCG
AGACGTTGACCCCATTCTA: GACGTTGACCCCATTCTAG
TTCTATTGGTTGGCCTAAC: TCTATTGGTTGGCCTAACC
GCATGGTTAGTCCTCGCCC: CATGGTTAGTCCTCGCCCT
GGTTAGATGGTTTGTACTC: GTTAGATGGTTTGTACTCC
CTGCATCTACACCGGTTTG: TGCATCTACACCGGTTTGG
TAACCCGAGGGTTCAGCGG: AACCCGAGGGTTCAGCGGA
GGGCGAGACGTTCTATTTC: GGCGAGACGTTCTATTTCA
TGTCACTCCAGGGACAGAA: GTCACTCCAGGGACAGAAA
ACTAAGCGGCTAGACGTTG: CTAAGCGGCTAGACGTTGA
GCAAGGCGAAGTATTGCGC: CAAGGCGAAGTATTGCGCA
TTGTCACTCCAGGGACAGA: TGTCACTCCAGGGACAGAA
AACACCAGATTTCTATTGG: ACACCAGATTTCTATTGGT
TTCCTTGAATTGGGGGAGG: TCCTTGAATTGGGGGAGGC
CTTATCACCTATGAGACAC: TTATCACCTATGAGACACT
CGTGTCTTCGCTTAGTGAA: GTGTCTTCGCTTAGTGAAG
TCCGAAAACAAAGGAGAGA: CCGAAAACAAAGGAGAGAG
CCTAAAGAAAGACGTACCC: CTAAAGAAAGACGTACCCC
TGATGCCGGCCATCCTTGA: GATGCCGGCCATCCTTGAT
CAGTTTTCGCATTTATTTC: AGTTTTCGCATTTATTTCG
AGATCTACATCACGGGCAA: GATCTACATCACGGGCAAT
CTTCACGAAGCCGTGAGCG: TTCACGAAGCCGTGAGCGA
GTAGTTCCTCTCGACTCTT: TAGTTCCTCTCGACTCTTC
GGGTAATTGAGTCACCTAT: GGTAATTGAGTCACCTATG
ATAACGAGCTCAGTGCCGC: TAACGAGCTCAGTGCCGCA
ATCTACACCGGTTTGGGCC: TCTACACCGGTTTGGGCCT
TGCGGAAGTACGTTAAGCC: GCGGAAGTACGTTAAGCCT
AAGTTGATTGGCATAGCTT: AGTTGATTGGCATAGCTTG
ATCACAGGGGCAGCACAGT: TCACAGGGGCAGCACAGTG
AGTGAAGTCCCGAGATATT: GTGAAGTCCCGAGATATTG
GGGCCTGGTTTTCACTTTA: GGCCTGGTTTTCACTTTAC
GCGGACCGAGTGGAGGCCT: CGGACCGAGTGGAGGCCTG
ACATCACGGGCAATATAGG: CATCACGGGCAATATAGGA
CTTTAGCTTAGCACACAGT: TTTAGCTTAGCACACAGTG
GTTTTTACCCCATTCTTCT: TTTTTACCCCATTCTTCTC
GCAGTCGTTCTGATGCACG: CAGTCGTTCTGATGCACGA
CCTCTTAATTAATCACAGT: CTCTTAATTAATCACAGTC
AGATGCCAAAGTTGATTGG: GATGCCAAAGTTGATTGGC
CCTATGAGACACTAGGCCC: CTATGAGACACTAGGCCCA
CATAGCATGGTTAGTCCTC: ATAGCATGGTTAGTCCTCG
TAGGCCCAGTGGTGTGCAA: AGGCCCAGTGGTGTGCAAA
GCCCTCTTAATTAATCACA: CCCTCTTAATTAATCACAG
CTAGGTCCGATATCTGTCT: TAGGTCCGATATCTGTCTC
ATTCTAGATCTACATCACG: TTCTAGATCTACATCACGG
ATTGATCATTTCCAACAGC: TTGATCATTTCCAACAGCA
ATATTGATCATTTCCAACA: TATTGATCATTTCCAACAG
CCATTCTTCTCTACCGCGG: CATTCTTCTCTACCGCGGA
CCGGGCGCTGTGCCCAGGA: CGGGCGCTGTGCCCAGGAT
CAGAAAGGAGATCCCACAT: AGAAAGGAGATCCCACATA
TTGGGTTATTTGGGTAATT: TGGGTTATTTGGGTAATTG
AGATGATGCGTGAGTGGTT: GATGATGCGTGAGTGGTTC
AAGGTGGGAGGCCAACCTT: AGGTGGGAGGCCAACCTTC
AGTCGTCCGAAAACAAAGG: GTCGTCCGAAAACAAAGGA
GCATGCTAAACCGGGATGG: CATGCTAAACCGGGATGGA
AATTGGGGGAGGCCGTAGC: ATTGGGGGAGGCCGTAGCC
TCGCTTTTGAGTCCTAAAG: CGCTTTTGAGTCCTAAAGA
GGTGTGCAAACACTCCCAG: GTGTGCAAACACTCCCAGT
GATCGGACTCCAGGCTTGC: ATCGGACTCCAGGCTTGCG
TCCGTGCCAAATTGCCATG: CCGTGCCAAATTGCCATGT
GGTTATTTGGGTAATTGAG: GTTATTTGGGTAATTGAGT
AGAAAGGAGATCCCACATA: GAAAGGAGATCCCACATAT
TGCCAAAGTTGATTGGCAT: GCCAAAGTTGATTGGCATA
AGACCTAGTGCCTACCTTG: GACCTAGTGCCTACCTTGC
GACGTTCTATTTCACCGGG: ACGTTCTATTTCACCGGGC
GCGTTGGCCGTCCTTTACC: CGTTGGCCGTCCTTTACCC
CGTCAAAATTACCATATTC: GTCAAAATTACCATATTCT
GCGGGCCATTGATACAGCT: CGGGCCATTGATACAGCTC
TGTACTCCTCGGAGGCAGC: GTACTCCTCGGAGGCAGCG
ATCCCCACAAGAGTCTAAA: TCCCCACAAGAGTCTAAAA
TGGCCTAACCCGAGGGTTC: GGCCTAACCCGAGGGTTCA
TCACAGTTTTCGCATTTAT: CACAGTTTTCGCATTTATT
GCTCACCTATGAGACACTA: CTCACCTATGAGACACTAG
CGCAGGGGCTGGTAGTCAG: GCAGGGGCTGGTAGTCAGG
TCCCATAGCATGGTTAGTC: CCCATAGCATGGTTAGTCC
CAACAGCAATCACAGGGGC: AACAGCAATCACAGGGGCA
CCGGTTTGGGCCTGTCTGA: CGGTTTGGGCCTGTCTGAT
TCGAATAACTTGTCACGTC: CGAATAACTTGTCACGTCA
CTCCGAGTGAATCCCGGAG: TCCGAGTGAATCCCGGAGT
GAGTGACCCGGGAGTTGTC: AGTGACCCGGGAGTTGTCA
ATGATCGTTTTTACCCCAT: TGATCGTTTTTACCCCATT
CATCCATAAATCCCCACAA: ATCCATAAATCCCCACAAG
CAGGCATGCTGCGTCGAAT: AGGCATGCTGCGTCGAATA
AGGAGACTCACACATTGGG: GGAGACTCACACATTGGGA
GGCCGTCCTTTACCCCAGA: GCCGTCCTTTACCCCAGAC
GCTACCCCCGTGTCTTCGC: CTACCCCCGTGTCTTCGCT
TTGGGATCCCAGGCATGAG: TGGGATCCCAGGCATGAGA
TCCTTTATCATAGGGCGCG: CCTTTATCATAGGGCGCGC
TCCAGGCTTGCGTTCCAAC: CCAGGCTTGCGTTCCAACA
AGGCGAGTACGGTAGGTTT: GGCGAGTACGGTAGGTTTA
CCGCAACGCACCAAGTGAC: CGCAACGCACCAAGTGACA
CTCATCATCCATAAATCCC: TCATCATCCATAAATCCCC
GTGGCTAGGAGACTCACAC: TGGCTAGGAGACTCACACA
GGACCTAAAAGACAATAAC: GACCTAAAAGACAATAACG
TTGTACTCCTCGGAGGCAG: TGTACTCCTCGGAGGCAGC
TTCCTCTCGACTCTTCTTT: TCCTCTCGACTCTTCTTTC
TGGTTGGCCTAACCCGAGG: GGTTGGCCTAACCCGAGGG
TTTTCTGGCGTTGGCCGTC: TTTCTGGCGTTGGCCGTCC
TGATCAAGGGCCTGGTTTT: GATCAAGGGCCTGGTTTTC
AGATAGGTTTTCTGGCGTT: GATAGGTTTTCTGGCGTTG
AACACTCCCAGTGATGATA: ACACTCCCAGTGATGATAT
ACCAATAATCATTGTGAGT: CCAATAATCATTGTGAGTC
GCACATCATCACCCGCACC: CACATCATCACCCGCACCC
TCTTATCGCCGGGTTTATC: CTTATCGCCGGGTTTATCA
TGTCGCACGCTTCTTGTGG: GTCGCACGCTTCTTGTGGA
GGAGTTGCCACAAGGTGGG: GAGTTGCCACAAGGTGGGA
TGGCATAGCTTGTGGCTAG: GGCATAGCTTGTGGCTAGG
CACTCCAGGGACAGAAAGG: ACTCCAGGGACAGAAAGGA
CTAGTGCCTACCTTGCAAC: TAGTGCCTACCTTGCAACA
GCGGATCTATGTTGTTTCA: CGGATCTATGTTGTTTCAG
TCACTAATTTGCCTCCGTC: CACTAATTTGCCTCCGTCG
TGGGTAATTGAGTCACCTA: GGGTAATTGAGTCACCTAT
CACAAGAGTCTAAAATGGA: ACAAGAGTCTAAAATGGAT
AATGCTACCCCCGTGTCTT: ATGCTACCCCCGTGTCTTC
GACCTAGTGCCTACCTTGC: ACCTAGTGCCTACCTTGCA
GAAGTCCCGAGATATTGAT: AAGTCCCGAGATATTGATC
TTGCAAGGCGAAGTATTGC: TGCAAGGCGAAGTATTGCG
CACGACTAGTCGTCCGAAA: ACGACTAGTCGTCCGAAAA
CGGATCTATGTTGTTTCAG: GGATCTATGTTGTTTCAGG
GCTCATCATCCATAAATCC: CTCATCATCCATAAATCCC
TTAGTGAAGTCCCGAGATA: TAGTGAAGTCCCGAGATAT
TGTTGCGGGAGTGACCCGG: GTTGCGGGAGTGACCCGGG
CAGTGGTGTGCAAACACTC: AGTGGTGTGCAAACACTCC
CTTCTTTCGCAGCACCGGC: TTCTTTCGCAGCACCGGCG
GGCTGTCACTAATTTGCCT: GCTGTCACTAATTTGCCTC
GAGTCCTAAAGAAAGACGT: AGTCCTAAAGAAAGACGTA
ACCGATGGTTATGCAAACA: CCGATGGTTATGCAAACAC
CCGGGAGTTGTCACTCCAG: CGGGAGTTGTCACTCCAGG
CCGGCCATCCTTGATCAAG: CGGCCATCCTTGATCAAGG
GAGTAACACTGTTCCTTTG: AGTAACACTGTTCCTTTGG
GGCTGGGATGTGAACGATC: GCTGGGATGTGAACGATCG
CAGTGCCGCAACGCACCAA: AGTGCCGCAACGCACCAAG
TTATCATAGGGCGCGCTGG: TATCATAGGGCGCGCTGGA
AGTCTAAAATGGATGATCG: GTCTAAAATGGATGATCGT
CTATCTCCGAGTGAATCCC: TATCTCCGAGTGAATCCCG
AGCACGACTAGTCGTCCGA: GCACGACTAGTCGTCCGAA
CCAGTGATTTCTTCTCTTC: CAGTGATTTCTTCTCTTCA
AGGTCTTATCGCCGGGTTT: GGTCTTATCGCCGGGTTTA
CCGGGATTCTAATAAGACA: CGGGATTCTAATAAGACAA
AACGCACCCGATACCTTTG: ACGCACCCGATACCTTTGG
CCCCAGACCTAGTGCCTAC: CCCAGACCTAGTGCCTACC
TCCCGGGCGCTGTGCCCAG: CCCGGGCGCTGTGCCCAGG
AGTCCTCGCCCTCTTAATT: GTCCTCGCCCTCTTAATTA
AGCTCAGGGATAGCGCACT: GCTCAGGGATAGCGCACTC
TGATCATTTCCAACAGCAA: GATCATTTCCAACAGCAAT
CTCAGGGATAGCGCACTCA: TCAGGGATAGCGCACTCAG
GTGACCCGGGAGTTGTCAC: TGACCCGGGAGTTGTCACT
ACTAATTTGCCTCCGTCGG: CTAATTTGCCTCCGTCGGA
CTTGAATTGGGGGAGGCCG: TTGAATTGGGGGAGGCCGT
TAATACCAGCCATACTGAA: AATACCAGCCATACTGAAA
GGGTTATTTGGGTAATTGA: GGTTATTTGGGTAATTGAG
ATTTGCCTCCGTCGGACTA: TTTGCCTCCGTCGGACTAG
CTAACCCGAGGGTTCAGCG: TAACCCGAGGGTTCAGCGG
TATACTCTTGCGGAAGTAC: ATACTCTTGCGGAAGTACG
TCCATAAATCCCCACAAGA: CCATAAATCCCCACAAGAG
GTTGAACTCTACCGCTATC: TTGAACTCTACCGCTATCT
TTGATCAAGGGCCTGGTTT: TGATCAAGGGCCTGGTTTT
GCCTAACCCGAGGGTTCAG: CCTAACCCGAGGGTTCAGC
TCTACACCGGTTTGGGCCT: CTACACCGGTTTGGGCCTG
TCGTTTTTACCCCATTCTT: CGTTTTTACCCCATTCTTC
AGTTGTCACTCCAGGGACA: GTTGTCACTCCAGGGACAG
TAAGCCTGTTCGCGTTACT: AAGCCTGTTCGCGTTACTC
CAGCATTCAGGCATGCTGC: AGCATTCAGGCATGCTGCG
TATTTCACCTATGAGACAC: ATTTCACCTATGAGACACT
TCCTTTGGTAAAAGATGAT: CCTTTGGTAAAAGATGATG
CAGTTATCCATTGCAAACA: AGTTATCCATTGCAAACAC
ACGACTAGTCGTCCGAAAA: CGACTAGTCGTCCGAAAAC
GAGGCAGCGGGCCATTGAT: AGGCAGCGGGCCATTGATA
ACAGTCGCGGCTGTCACTA: CAGTCGCGGCTGTCACTAA
GCCGGCCATCCTTGATCAA: CCGGCCATCCTTGATCAAG
TGTCCAGCATTCAGGCATG: GTCCAGCATTCAGGCATGC
GCAACGCACCAAGTGACAA: CAACGCACCAAGTGACAAT
TGGGGGAGGCCGTAGCCCA: GGGGGAGGCCGTAGCCCAA
TGTCACTAATTTGCCTCCG: GTCACTAATTTGCCTCCGT
CAGACCAGTCAGATAGGTT: AGACCAGTCAGATAGGTTT
AGTGACGCTGCTCACCTAT: GTGACGCTGCTCACCTATG
TGGTTAGTCCTCGCCCTCT: GGTTAGTCCTCGCCCTCTT
AACACCCGGGTGACTAGTC: ACACCCGGGTGACTAGTCT
TTTAGTACGCCTGTACTTG: TTAGTACGCCTGTACTTGG
CGACTCTTCTTTCGCAGCA: GACTCTTCTTTCGCAGCAC
GCAGCACAGTGATGCCGGC: CAGCACAGTGATGCCGGCC
CCCATAGCATGGTTAGTCC: CCATAGCATGGTTAGTCCT
AACAGAGTTTGGTCCTTTA: ACAGAGTTTGGTCCTTTAT
GAGCGAGACGCAGTCGTTC: AGCGAGACGCAGTCGTTCT
TTATCACAGTTTTCGCATT: TATCACAGTTTTCGCATTT
GCGCTGGACCTAGACGTGG: CGCTGGACCTAGACGTGGC
AAGCCTGTTCGCGTTACTC: AGCCTGTTCGCGTTACTCC
CTGGAGTTCCGGATGTTCC: TGGAGTTCCGGATGTTCCC
AAACACTCCCAGTGATTAT: AACACTCCCAGTGATTATC
TTATTTTACAGGCCTCGCT: TATTTTACAGGCCTCGCTT
GGCCAACCTTCCCTGGGCG: GCCAACCTTCCCTGGGCGA
AGGCCGTAGCCCAAGCACG: GGCCGTAGCCCAAGCACGA
CAGCCATACTGAAAAATTT: AGCCATACTGAAAAATTTA
CGTTTTTACCCCATTCTTC: GTTTTTACCCCATTCTTCT
ACTTGGGTTATTTGGGTAA: CTTGGGTTATTTGGGTAAT
TATTTCGCAGCTACTCGTG: ATTTCGCAGCTACTCGTGT
CACTCAGTCGTCACCGACT: ACTCAGTCGTCACCGACTA
AATCTTAATTCGCTCCGTG: ATCTTAATTCGCTCCGTGT
AAAAGACAATAACGAGCTC: AAAGACAATAACGAGCTCA
CTCGGAACGCACCCGATAC: TCGGAACGCACCCGATACC
ATTAACTAAAAAAACCCAC: TTAACTAAAAAAACCCACA
GTGGTGTGCAAACACTCCC: TGGTGTGCAAACACTCCCA
ACCGATCCCGCCAAGGACC: CCGATCCCGCCAAGGACCT
TCTTCTCTTCACGAAGCCG: CTTCTCTTCACGAAGCCGT
ATGCTGCGTCGAATAACTT: TGCTGCGTCGAATAACTTG
CCTCGCTTTTGAGTCCTAA: CTCGCTTTTGAGTCCTAAA
TAGTGCCTACCTTGCAACA: AGTGCCTACCTTGCAACAC
CGTTACTCCTGCGGCGATG: GTTACTCCTGCGGCGATGT
TTATCACCTATGAGACACT: TATCACCTATGAGACACTA
GGTCTTATCGCCGGGTTTA: GTCTTATCGCCGGGTTTAT
TTCCGTGCCATAGGAAACA: TCCGTGCCATAGGAAACAC
TCTTCTCTACCGCGGATCT: CTTCTCTACCGCGGATCTA
ACAGAAAGGAGATCCCACA: CAGAAAGGAGATCCCACAT
AGTTCCGGATGTTCCCGGG: GTTCCGGATGTTCCCGGGC
TCCGATATCTGTCTCGGAA: CCGATATCTGTCTCGGAAC
CCCTCCTTTATCATAGGGC: CCTCCTTTATCATAGGGCG
CAAGAGTCTAAAATGGATG: AAGAGTCTAAAATGGATGA
GTATTAAGGTCCGATAGCC: TATTAAGGTCCGATAGCCG
ACAAGAGTCTAAAATGGAT: CAAGAGTCTAAAATGGATG
TTCGAGTTATAGTGACGCT: TCGAGTTATAGTGACGCTG
TCCTAAAGAAAGACGTACC: CCTAAAGAAAGACGTACCC
TTCCAACAGCAATCACAGG: TCCAACAGCAATCACAGGG
CACCGGGCACATCATCACC: ACCGGGCACATCATCACCC
CGCAACGCACCAAGTGACA: GCAACGCACCAAGTGACAA
TACCCCAGACCTAGTGCCT: ACCCCAGACCTAGTGCCTA
GTAGATCGGACTCCAGGCT: TAGATCGGACTCCAGGCTT
TTGCGGGAGTGACCCGGGA: TGCGGGAGTGACCCGGGAG
CGTGCCAAATTGCCATGTG: GTGCCAAATTGCCATGTGT
CGCACCCGATACCTTTGGT: GCACCCGATACCTTTGGTT
GAACTCTACCGCTATCTCC: AACTCTACCGCTATCTCCG
GTCACGGTCTAGCGGCCGG: TCACGGTCTAGCGGCCGGG
TTGGGCCTGTCTGATAACC: TGGGCCTGTCTGATAACCG
AATTTGCCTCCGTCGGACT: ATTTGCCTCCGTCGGACTA
TTTCGCATTTATTTCGCAG: TTCGCATTTATTTCGCAGC
TTGTGGCTAGGAGACTCAC: TGTGGCTAGGAGACTCACA
TAGATGCCAAAGTTGATTG: AGATGCCAAAGTTGATTGG
TCGCTCCGTGTCTCCCTAT: CGCTCCGTGTCTCCCTATG
GTTGCCACAAGGTGGGAGG: TTGCCACAAGGTGGGAGGC
GGAGAGAGGTCTTATCGCC: GAGAGAGGTCTTATCGCCG
GATCCCAGGCATGAGAACC: ATCCCAGGCATGAGAACCT
CCGTGCCAAATTGCCATGT: CGTGCCAAATTGCCATGTG
TGAGACACTAGCAGTTATC: GAGACACTAGCAGTTATCC
AGCACAGTGATGCCGGCCA: GCACAGTGATGCCGGCCAT
TCCCAGTGATTATCACAGT: CCCAGTGATTATCACAGTT
TCACCGGGCACATCATCAC: CACCGGGCACATCATCACC
AGGCATGCTGCGTCGAATA: GGCATGCTGCGTCGAATAA
TACGCCTGTACTTGGGTTA: ACGCCTGTACTTGGGTTAT
ATTCAGGCATGCTGCGTCG: TTCAGGCATGCTGCGTCGA
TCGCAGCACCGGCGTCAGA: CGCAGCACCGGCGTCAGAC
AAGTTGAACTCTACCGCTA: AGTTGAACTCTACCGCTAT
CCAGTGGTGTGCAAACACT: CAGTGGTGTGCAAACACTC
TCCGTCGGACTAGTTTCTC: CCGTCGGACTAGTTTCTCG
TGCAACACCAGATTTCTAT: GCAACACCAGATTTCTATT
GTGACGCTGCTCACCTATG: TGACGCTGCTCACCTATGA
GTGTGAACTTTGCAAACAC: TGTGAACTTTGCAAACACT
AAGTGACGAGAAATAATAC: AGTGACGAGAAATAATACC
GAAATAATACCAGCCATAC: AAATAATACCAGCCATACT
ATCCCGGAGTTGGATTAGG: TCCCGGAGTTGGATTAGGT
TTCCAACAGAGTTTGGTCC: TCCAACAGAGTTTGGTCCT
TGCTCATCATCCATAAATC: GCTCATCATCCATAAATCC
ATTGGTTGGCCTAACCCGA: TTGGTTGGCCTAACCCGAG
GCCCAGTGGTGTGCAAACA: CCCAGTGGTGTGCAAACAC
ATTCTAATAAGACAATGTC: TTCTAATAAGACAATGTCC
CGGTAGGTTTATTTAATGC: GGTAGGTTTATTTAATGCT
TTCAGCATGCTAAACCGGG: TCAGCATGCTAAACCGGGA
GATAGCCGGAGTTGCCACA: ATAGCCGGAGTTGCCACAA
TGACCCCATTCTAGATCTA: GACCCCATTCTAGATCTAC
CCATCCTTGATCAAGGGCC: CATCCTTGATCAAGGGCCT
GTTCCCGGGCGCTGTGCCC: TTCCCGGGCGCTGTGCCCA
CGGAAGTACGTTAAGCCTG: GGAAGTACGTTAAGCCTGT
AAAGAAAGACGTACCCCTC: AAGAAAGACGTACCCCTCC
CTCAGTCGTCACCGACTAA: TCAGTCGTCACCGACTAAG
TAAGCGGCTAGACGTTGAC: AAGCGGCTAGACGTTGACC
AGCTTAGCACACAGTGCTC: GCTTAGCACACAGTGCTCA
CCAAGGACCTTATCACCTA: CAAGGACCTTATCACCTAT
CTCATTCTTTAGCTTAGCA: TCATTCTTTAGCTTAGCAC
GCTGTGCCCAGGATATTAA: CTGTGCCCAGGATATTAAC
CCCGTGTCTTCGCTTAGTG: CCGTGTCTTCGCTTAGTGA
AGAGAGGTCTTATCGCCGG: GAGAGGTCTTATCGCCGGG
GATGATGCGTGAGTGGTTC: ATGATGCGTGAGTGGTTCA
TATTCTGGAGTTCCGGATG: ATTCTGGAGTTCCGGATGT
GATCTATGTTGTTTCAGGA: ATCTATGTTGTTTCAGGAT
TTACCATATTCTGGAGTTC: TACCATATTCTGGAGTTCC
GGTTTATTTAATGCTACCC: GTTTATTTAATGCTACCCC
TGACCGATCCCGCCAAGGA: GACCGATCCCGCCAAGGAC
AATTGAGTCACCTATGAGA: ATTGAGTCACCTATGAGAC
GTGGGAGGCCAACCTTCCC: TGGGAGGCCAACCTTCCCT
GAGGCCGTAGCCCAAGCAC: AGGCCGTAGCCCAAGCACG
CCCATTCTAGATCTACATC: CCATTCTAGATCTACATCA
ACCCCATTCTTCTCTACCG: CCCCATTCTTCTCTACCGC
TTCTTGTGGACCTAAAAGA: TCTTGTGGACCTAAAAGAC
AATGTCCAGCATTCAGGCA: ATGTCCAGCATTCAGGCAT
AGTGTGTGAACTTTGCAAA: GTGTGTGAACTTTGCAAAC
CATTCTTCTCTACCGCGGA: ATTCTTCTCTACCGCGGAT
GCTAGGTCCGATATCTGTC: CTAGGTCCGATATCTGTCT
GTTCAGCGGATAGATGCCA: TTCAGCGGATAGATGCCAA
GGGATCCCAGGCATGAGAA: GGATCCCAGGCATGAGAAC
CGCTTTTGAGTCCTAAAGA: GCTTTTGAGTCCTAAAGAA
TCCCAGTGATTTCTTCTCT: CCCAGTGATTTCTTCTCTT
GAGACACTAGCAGTTATCC: AGACACTAGCAGTTATCCA
GTATTGCGCAGGGGCTGGT: TATTGCGCAGGGGCTGGTA
AGGTTTATTTAATGCTACC: GGTTTATTTAATGCTACCC
AGTCACGGTCTAGCGGCCG: GTCACGGTCTAGCGGCCGG
CTCCCAGTGATTTATGTAC: TCCCAGTGATTTATGTACC
ATCATTTCCAACAGCAATC: TCATTTCCAACAGCAATCA
CCCGCCAAGGACCTTATCA: CCGCCAAGGACCTTATCAC
CTCCGTCGGACTAGTTTCT: TCCGTCGGACTAGTTTCTC
ATTTAGTACGCCTGTACTT: TTTAGTACGCCTGTACTTG
AGGAAACACCCGGGTGACT: GGAAACACCCGGGTGACTA
CGAGTTATAGTGACGCTGC: GAGTTATAGTGACGCTGCT
TTCAGGATTCCGTGCCATA: TCAGGATTCCGTGCCATAG
CCGCACCCGCGAAACTGCA: CGCACCCGCGAAACTGCAT
ATCCCGCCAAGGACCTTAT: TCCCGCCAAGGACCTTATC
GCCACAAGGTGGGAGGCCA: CCACAAGGTGGGAGGCCAA
CACAGTTTTCGCATTTATT: ACAGTTTTCGCATTTATTT
GCCGTCCTTTACCCCAGAC: CCGTCCTTTACCCCAGACC
ACACTAGCAGTTATCCATT: CACTAGCAGTTATCCATTG
GTACGGTAGGTTTATTTAA: TACGGTAGGTTTATTTAAT
ATGCTACCCCCGTGTCTTC: TGCTACCCCCGTGTCTTCG
TGCATCTACACCGGTTTGG: GCATCTACACCGGTTTGGG
AGCACCGGCGTCAGACCAG: GCACCGGCGTCAGACCAGT
ATTAGGTAGATCGGACTCC: TTAGGTAGATCGGACTCCA
CCATACTGAAAAATTTAGT: CATACTGAAAAATTTAGTA
ATTTCGCAGCTACTCGTGT: TTTCGCAGCTACTCGTGTC
ATGCTCGTTAGGCGAGTAC: TGCTCGTTAGGCGAGTACG
GCCAACCTTCCCTGGGCGA: CCAACCTTCCCTGGGCGAG
CATAGCTTGTGGCTAGGAG: ATAGCTTGTGGCTAGGAGA
AGATTTCTATTGGTTGGCC: GATTTCTATTGGTTGGCCT
CATTCAGGCATGCTGCGTC: ATTCAGGCATGCTGCGTCG
GCGGCTAGACGTTGACCCC: CGGCTAGACGTTGACCCCA
ACAGTGATGCCGGCCATCC: CAGTGATGCCGGCCATCCT
TCACGTCAAAATTACCATA: CACGTCAAAATTACCATAT
TGAGGGTTCCTTGAATTGG: GAGGGTTCCTTGAATTGGG
GGCCATTGATACAGCTCAG: GCCATTGATACAGCTCAGG
GTTTCAGGATTCCGTGCCA: TTTCAGGATTCCGTGCCAT
TCTTGTCGCACGCTTCTTG: CTTGTCGCACGCTTCTTGT
TGAACGATCGAGAACGCGT: GAACGATCGAGAACGCGTA
TTTCTTCTCTTCACGAAGC: TTCTTCTCTTCACGAAGCC
CTCTTAATTAATCACAGTC: TCTTAATTAATCACAGTCG
CCTACCTTGCAACACCAGA: CTACCTTGCAACACCAGAT
GAGGCCAACCTTCCCTGGG: AGGCCAACCTTCCCTGGGC
CAGGCTTGCGTTCCAACAG: AGGCTTGCGTTCCAACAGA
CGATCCCGCCAAGGACCTT: GATCCCGCCAAGGACCTTA
ATTATCACAGTTTTCGCAT: TTATCACAGTTTTCGCATT
GGGCCATTGATACAGCTCA: GGCCATTGATACAGCTCAG
AGCTTGTGGCTAGGAGACT: GCTTGTGGCTAGGAGACTC
TGATTGGCATAGCTTGTGG: GATTGGCATAGCTTGTGGC
GGAGTTCCGGATGTTCCCG: GAGTTCCGGATGTTCCCGG
CTCTACCGCGGATCTATGT: TCTACCGCGGATCTATGTT
CATTTCCAACAGCAATCAC: ATTTCCAACAGCAATCACA
GCTTGTGGCTAGGAGACTC: CTTGTGGCTAGGAGACTCA
ATCTTTCATCCAGGCTTGA: TCTTTCATCCAGGCTTGAG
CCAAGCACGACTAGTCGTC: CAAGCACGACTAGTCGTCC
AGTTTTCGCATTTATTTCG: GTTTTCGCATTTATTTCGC
ATTCTTTAGCTTAGCACAC: TTCTTTAGCTTAGCACACA
CTTGAGGCCCTCCTTTATC: TTGAGGCCCTCCTTTATCA
GTGACAATCTTAATTCGCT: TGACAATCTTAATTCGCTC
GAGTTCCGGATGTTCCCGG: AGTTCCGGATGTTCCCGGG
ATGAGACACTAGTGTGTGA: TGAGACACTAGTGTGTGAA
GTACGTTAAGCCTGTTCGC: TACGTTAAGCCTGTTCGCG
ATGTTCCCGGGCGCTGTGC: TGTTCCCGGGCGCTGTGCC
CAGCGGGCCATTGATACAG: AGCGGGCCATTGATACAGC
CTGTCTCGGAACGCACCCG: TGTCTCGGAACGCACCCGA
TGCGGGAGTGACCCGGGAG: GCGGGAGTGACCCGGGAGT
CTCGCTTTTGAGTCCTAAA: TCGCTTTTGAGTCCTAAAG
GGGATAGCGCACTCAGTCG: GGATAGCGCACTCAGTCGT
GTCGTCCGAAAACAAAGGA: TCGTCCGAAAACAAAGGAG
GTAACACTGTTCCTTTGGT: TAACACTGTTCCTTTGGTA
GCTAGACGTTGACCCCATT: CTAGACGTTGACCCCATTC
GGCCTGCGTGACCGATCCC: GCCTGCGTGACCGATCCCG
GTTTATTTAATGCTACCCC: TTTATTTAATGCTACCCCC
AATTAATCACAGTCGCGGC: ATTAATCACAGTCGCGGCT
CCAGCCATACTGAAAAATT: CAGCCATACTGAAAAATTT
GGATTCCGTGCCATAGGAA: GATTCCGTGCCATAGGAAA
CCAACAGAGTTTGGTCCTT: CAACAGAGTTTGGTCCTTT
TATCAGAGAGGGGTAGTCA: ATCAGAGAGGGGTAGTCAC
AACTTTGCAAACACTCCCA: ACTTTGCAAACACTCCCAG
TCATCCATAAATCCCCACA: CATCCATAAATCCCCACAA
CAGGCTTGAGGCCCTCCTT: AGGCTTGAGGCCCTCCTTT
GGACCGAGTGGAGGCCTGC: GACCGAGTGGAGGCCTGCG
CTGTGCAATCTTTCATCCA: TGTGCAATCTTTCATCCAG
TGAGACACTAGTGTGTGAA: GAGACACTAGTGTGTGAAC
GAGACACTAGACCGATGGT: AGACACTAGACCGATGGTT
CTAAAAAAACCCACACAGG: TAAAAAAACCCACACAGGC
TGTGAACTTTGCAAACACT: GTGAACTTTGCAAACACTC
CGGAGTTGGATTAGGTAGA: GGAGTTGGATTAGGTAGAT
GTCAGGTAAAGTGACGAGA: TCAGGTAAAGTGACGAGAA
ATTCCGTGCCATAGGAAAC: TTCCGTGCCATAGGAAACA
CTTGGGTTATTTGGGTAAT: TTGGGTTATTTGGGTAATT
TCATCATCCATAAATCCCC: CATCATCCATAAATCCCCA
CGGCGATGTAGTTCCTCTC: GGCGATGTAGTTCCTCTCG
CCGTCGGACTAGTTTCTCG: CGTCGGACTAGTTTCTCGT
CATAGGGCGCGCTGGACCT: ATAGGGCGCGCTGGACCTA
TAGCCGGAGTTGCCACAAG: AGCCGGAGTTGCCACAAGG
CACTGTTCCTTTGGTAAAA: ACTGTTCCTTTGGTAAAAG
GCAGCACCGGCGTCAGACC: CAGCACCGGCGTCAGACCA
CACTCCCAGTGATTTATGT: ACTCCCAGTGATTTATGTA
GACGCAGTCGTTCTGATGC: ACGCAGTCGTTCTGATGCA
TTTGAGTCCTAAAGAAAGA: TTGAGTCCTAAAGAAAGAC
TTGGGTAATTGAGTCACCT: TGGGTAATTGAGTCACCTA
TCCTTGAATTGGGGGAGGC: CCTTGAATTGGGGGAGGCC
TTTCATCCAGGCTTGAGGC: TTCATCCAGGCTTGAGGCC
GGTTCCTTGAATTGGGGGA: GTTCCTTGAATTGGGGGAG
AACTAAAAAAACCCACACA: ACTAAAAAAACCCACACAG
CGCTGTGCCCAGGATATTA: GCTGTGCCCAGGATATTAA
AAACACTCCCAGTGATTTC: AACACTCCCAGTGATTTCT
CCCGGGTGACTAGTCTGTG: CCGGGTGACTAGTCTGTGC
TGTGAGTCTTGTCGCACGC: GTGAGTCTTGTCGCACGCT
CAGCATGCTAAACCGGGAT: AGCATGCTAAACCGGGATG
TTAATCACAGTCGCGGCTG: TAATCACAGTCGCGGCTGT
GCCAAGGACCTTATCACCT: CCAAGGACCTTATCACCTA
CGAGCTCAGTGCCGCAACG: GAGCTCAGTGCCGCAACGC
ACTCCCAGTGATTTCTTCT: CTCCCAGTGATTTCTTCTC
CAGCTACTCGTGTCGTCCC: AGCTACTCGTGTCGTCCCA
AAACTGCATCTACACCGGT: AACTGCATCTACACCGGTT
CCTAGTGCCTACCTTGCAA: CTAGTGCCTACCTTGCAAC
TGCCACAAGGTGGGAGGCC: GCCACAAGGTGGGAGGCCA
GGGCACATCATCACCCGCA: GGCACATCATCACCCGCAC
TCCTTTATGAGTAACACTG: CCTTTATGAGTAACACTGT
CGCATTTATTTCGCAGCTA: GCATTTATTTCGCAGCTAC
TGTTCCTTTGGTAAAAGAT: GTTCCTTTGGTAAAAGATG
CTAGTGTGTGAACTTTGCA: TAGTGTGTGAACTTTGCAA
AACCCACACAGGCTAGGTC: ACCCACACAGGCTAGGTCC
CCCACATATTTCACCTATG: CCACATATTTCACCTATGA
GAGATATTGATCATTTCCA: AGATATTGATCATTTCCAA
CTCGTGTCGTCCCATAGCA: TCGTGTCGTCCCATAGCAT
TCCCGCCAAGGACCTTATC: CCCGCCAAGGACCTTATCA
TCGCCCTCTTAATTAATCA: CGCCCTCTTAATTAATCAC
CCTAGACGTGGCTGGGATG: CTAGACGTGGCTGGGATGT
GACTCACACATTGGGATCC: ACTCACACATTGGGATCCC
GATTATCACAGTTTTCGCA: ATTATCACAGTTTTCGCAT
GCCGTAGCCCAAGCACGAC: CCGTAGCCCAAGCACGACT
AACTGCATCTACACCGGTT: ACTGCATCTACACCGGTTT
GTCCTTTATGAGTAACACT: TCCTTTATGAGTAACACTG
CGCGAAACTGCATCTACAC: GCGAAACTGCATCTACACC
CGGAGGCAGCGGGCCATTG: GGAGGCAGCGGGCCATTGA
GCCATGTGTTGCGGGAGTG: CCATGTGTTGCGGGAGTGA
TATGAGTAACACTGTTCCT: ATGAGTAACACTGTTCCTT
CGTTCTGATGCACGATGCT: GTTCTGATGCACGATGCTC
ATGCCGGCCATCCTTGATC: TGCCGGCCATCCTTGATCA
TGAGTCCTAAAGAAAGACG: GAGTCCTAAAGAAAGACGT
TCTATGTTGTTTCAGGATT: CTATGTTGTTTCAGGATTC
GCCCTCCTTTATCATAGGG: CCCTCCTTTATCATAGGGC
CGATGTAGTTCCTCTCGAC: GATGTAGTTCCTCTCGACT
ACACCGGTTTGGGCCTGTC: CACCGGTTTGGGCCTGTCT
GACGAGAAATAATACCAGC: ACGAGAAATAATACCAGCC
GCACCAAGTGACAATCTTA: CACCAAGTGACAATCTTAA
TTGGATTAGGTAGATCGGA: TGGATTAGGTAGATCGGAC
ACCCGATACCTTTGGTTAG: CCCGATACCTTTGGTTAGA
CCTCGGAGGCAGCGGGCCA: CTCGGAGGCAGCGGGCCAT
CCTCATTCTTTAGCTTAGC: CTCATTCTTTAGCTTAGCA
CGTGACCGATCCCGCCAAG: GTGACCGATCCCGCCAAGG
TCAGATAGGTTTTCTGGCG: CAGATAGGTTTTCTGGCGT
CAAAGTTGATTGGCATAGC: AAAGTTGATTGGCATAGCT
TCGGACTAGTTTCTCGTTC: CGGACTAGTTTCTCGTTCG
AAATGGATGATCGTTTTTA: AATGGATGATCGTTTTTAC
AGTTGATTGGCATAGCTTG: GTTGATTGGCATAGCTTGT
AAAAATTTAGTACGCCTGT: AAAATTTAGTACGCCTGTA
CACGGGCAATATAGGAAAG: ACGGGCAATATAGGAAAGC
AATCATTGTGAGTCTTGTC: ATCATTGTGAGTCTTGTCG
AGGGGCTGGTAGTCAGGTA: GGGGCTGGTAGTCAGGTAA
TGTGGACCTAAAAGACAAT: GTGGACCTAAAAGACAATA
GTCTAAAATGGATGATCGT: TCTAAAATGGATGATCGTT
GGCCCAGTGGTGTGCAAAC: GCCCAGTGGTGTGCAAACA
ATAATCATTGTGAGTCTTG: TAATCATTGTGAGTCTTGT
TTCACCGGGCACATCATCA: TCACCGGGCACATCATCAC
CCAGACCTAGTGCCTACCT: CAGACCTAGTGCCTACCTT
TGAATCCCGGAGTTGGATT: GAATCCCGGAGTTGGATTA
TAGTACGCCTGTACTTGGG: AGTACGCCTGTACTTGGGT
CCCGGGCGCTGTGCCCAGG: CCGGGCGCTGTGCCCAGGA
TTATTTGGGTAATTGAGTC: TATTTGGGTAATTGAGTCA
CCAAATTGCCATGTGTTGC: CAAATTGCCATGTGTTGCG
GCGTTACTCCTGCGGCGAT: CGTTACTCCTGCGGCGATG
CACCCGGGTGACTAGTCTG: ACCCGGGTGACTAGTCTGT
AAGAAAGACGTACCCCTCC: AGAAAGACGTACCCCTCCC
GTGATTTCTTCTCTTCACG: TGATTTCTTCTCTTCACGA
ATCACCTATGAGACACTAG: TCACCTATGAGACACTAGA
GAGCTCAGTGCCGCAACGC: AGCTCAGTGCCGCAACGCA
AGTTATAGTGACGCTGCTC: GTTATAGTGACGCTGCTCA
TTAAGGTCCGATAGCCGGA: TAAGGTCCGATAGCCGGAG
CTGATGCACGATGCTCGTT: TGATGCACGATGCTCGTTA
ATACTGAAAAATTTAGTAC: TACTGAAAAATTTAGTACG
GAGTACGGTAGGTTTATTT: AGTACGGTAGGTTTATTTA
CAGTGATGATATTATTTTA: AGTGATGATATTATTTTAC
CTTTACCCCAGACCTAGTG: TTTACCCCAGACCTAGTGC
ACGTTCTATTTCACCGGGC: CGTTCTATTTCACCGGGCA
TTAACTAAAAAAACCCACA: TAACTAAAAAAACCCACAC
AAAAAAACCCACACAGGCT: AAAAAACCCACACAGGCTA
GGTCCTTTATGAGTAACAC: GTCCTTTATGAGTAACACT
GCCTACCTTGCAACACCAG: CCTACCTTGCAACACCAGA
ACCCACACAGGCTAGGTCC: CCCACACAGGCTAGGTCCG
AGGCGAAGTATTGCGCAGG: GGCGAAGTATTGCGCAGGG
TAAGGTCCGATAGCCGGAG: AAGGTCCGATAGCCGGAGT
GCACCGGCGTCAGACCAGT: CACCGGCGTCAGACCAGTC
AGTCGTCACCGACTAAGCG: GTCGTCACCGACTAAGCGG
TATTTCACCGGGCACATCA: ATTTCACCGGGCACATCAT
GCAACACCAGATTTCTATT: CAACACCAGATTTCTATTG
CCCCATTCTAGATCTACAT: CCCATTCTAGATCTACATC
TTTGGGCCTGTCTGATAAC: TTGGGCCTGTCTGATAACC
GTCAGATAGGTTTTCTGGC: TCAGATAGGTTTTCTGGCG
GGGCAGCACAGTGATGCCG: GGCAGCACAGTGATGCCGG
CATCCTTGATCAAGGGCCT: ATCCTTGATCAAGGGCCTG
TAGATGGTTTGTACTCCTC: AGATGGTTTGTACTCCTCG
CCCCATCAGCGGACCGAGT: CCCATCAGCGGACCGAGTG
GATAGGTTTTCTGGCGTTG: ATAGGTTTTCTGGCGTTGG
AAAGTTGATTGGCATAGCT: AAGTTGATTGGCATAGCTT
TTGCCATGTGTTGCGGGAG: TGCCATGTGTTGCGGGAGT
TATTGATCATTTCCAACAG: ATTGATCATTTCCAACAGC
TCAGTCGTCACCGACTAAG: CAGTCGTCACCGACTAAGC
CCCCGTGTCTTCGCTTAGT: CCCGTGTCTTCGCTTAGTG
GCTATCTCCGAGTGAATCC: CTATCTCCGAGTGAATCCC
AATAATACCAGCCATACTG: ATAATACCAGCCATACTGA
TCGCCGGGTTTATCAGAGA: CGCCGGGTTTATCAGAGAG
ACACTGTTCCTTTGGTAAA: CACTGTTCCTTTGGTAAAA
TATCACCTATGAGACACTA: ATCACCTATGAGACACTAG
TCTTTCATCCAGGCTTGAG: CTTTCATCCAGGCTTGAGG
GTGCCAAATTGCCATGTGT: TGCCAAATTGCCATGTGTT
AACCCGAGGGTTCAGCGGA: ACCCGAGGGTTCAGCGGAT
GCAAACACTCCCAGTGATG: CAAACACTCCCAGTGATGA
GTTAAGCCTGTTCGCGTTA: TTAAGCCTGTTCGCGTTAC
ACTCCCAGTGATTATCACA: CTCCCAGTGATTATCACAG
CTACTCGTGTCGTCCCATA: TACTCGTGTCGTCCCATAG
TTGGCCTAACCCGAGGGTT: TGGCCTAACCCGAGGGTTC
AGACGCAGTCGTTCTGATG: GACGCAGTCGTTCTGATGC
CTTCGCTTAGTGAAGTCCC: TTCGCTTAGTGAAGTCCCG
TGTGTTGCGGGAGTGACCC: GTGTTGCGGGAGTGACCCG
GACGTACCCCTCCCCATCA: ACGTACCCCTCCCCATCAG
GTTCCTTTGGTAAAAGATG: TTCCTTTGGTAAAAGATGA
AAAGATGATGCGTGAGTGG: AAGATGATGCGTGAGTGGT
AGTCCCGAGATATTGATCA: GTCCCGAGATATTGATCAT
GGCTGGTAGTCAGGTAAAG: GCTGGTAGTCAGGTAAAGT
CTTTATGAGTAACACTGTT: TTTATGAGTAACACTGTTC
GCGTGAGTGGTTCAGCATG: CGTGAGTGGTTCAGCATGC
CGAGACGTTCTATTTCACC: GAGACGTTCTATTTCACCG
AATACCAGCCATACTGAAA: ATACCAGCCATACTGAAAA
ACGCACCAAGTGACAATCT: CGCACCAAGTGACAATCTT
TGACTAGTCTGTGCAATCT: GACTAGTCTGTGCAATCTT
GGAGATCCCACATATTTCA: GAGATCCCACATATTTCAC
AAGACGTACCCCTCCCCAT: AGACGTACCCCTCCCCATC
TTATAGTGACGCTGCTCAC: TATAGTGACGCTGCTCACC
CTAGTCTGTGCAATCTTTC: TAGTCTGTGCAATCTTTCA
GGCAGCACAGTGATGCCGG: GCAGCACAGTGATGCCGGC
AAGGGCCTGGTTTTCACTT: AGGGCCTGGTTTTCACTTT
CAGGGACAGAAAGGAGATC: AGGGACAGAAAGGAGATCC
GGCGCGCTGGACCTAGACG: GCGCGCTGGACCTAGACGT
CCATTGATACAGCTCAGGG: CATTGATACAGCTCAGGGA
ACCTATGAGACACTAGGCC: CCTATGAGACACTAGGCCC
AAACAAAGGAGAGAGGTCT: AACAAAGGAGAGAGGTCTT
CGCTCCGTGTCTCCCTATG: GCTCCGTGTCTCCCTATGA
TATTGGTTGGCCTAACCCG: ATTGGTTGGCCTAACCCGA
AGGTCCGATATCTGTCTCG: GGTCCGATATCTGTCTCGG
AGTCAGATAGGTTTTCTGG: GTCAGATAGGTTTTCTGGC
CCCAGTGATTTATGTACCA: CCAGTGATTTATGTACCAA
CACGCTTCTTGTGGACCTA: ACGCTTCTTGTGGACCTAA
GCCGTGAGCGAGACGCAGT: CCGTGAGCGAGACGCAGTC
ACAGGGGCAGCACAGTGAT: CAGGGGCAGCACAGTGATG
GGATAGATGCCAAAGTTGA: GATAGATGCCAAAGTTGAT
GAGTCACCTATGAGACACT: AGTCACCTATGAGACACTA
CTAGCGGCCGGGATTCTAA: TAGCGGCCGGGATTCTAAT
CTCCCAGTGATTTCTTCTC: TCCCAGTGATTTCTTCTCT
CGTTGGCCGTCCTTTACCC: GTTGGCCGTCCTTTACCCC
TGCTGCGTCGAATAACTTG: GCTGCGTCGAATAACTTGT
CTTAATTAATCACAGTCGC: TTAATTAATCACAGTCGCG
GGGCCTGTCTGATAACCGG: GGCCTGTCTGATAACCGGT
GTCTTCGCTTAGTGAAGTC: TCTTCGCTTAGTGAAGTCC
AGACACTAGGCCCAGTGGT: GACACTAGGCCCAGTGGTG
GAACTTTGCAAACACTCCC: AACTTTGCAAACACTCCCA
TTGTTTCAGGATTCCGTGC: TGTTTCAGGATTCCGTGCC
GCCAAATTGCCATGTGTTG: CCAAATTGCCATGTGTTGC
AACACTGTTCCTTTGGTAA: ACACTGTTCCTTTGGTAAA
TTTAGCTTAGCACACAGTG: TTAGCTTAGCACACAGTGC
GTACTCCTCGGAGGCAGCG: TACTCCTCGGAGGCAGCGG
TATTAACTAAAAAAACCCA: ATTAACTAAAAAAACCCAC
TTAATGCTACCCCCGTGTC: TAATGCTACCCCCGTGTCT
CACCCGATACCTTTGGTTA: ACCCGATACCTTTGGTTAG
CCGAGTGAATCCCGGAGTT: CGAGTGAATCCCGGAGTTG
CTACCTTGCAACACCAGAT: TACCTTGCAACACCAGATT
GGGATGGAGTATACTCTTG: GGATGGAGTATACTCTTGC
ATGTACCAATAATCATTGT: TGTACCAATAATCATTGTG
AGAGTCTAAAATGGATGAT: GAGTCTAAAATGGATGATC
CGGGCGCTGTGCCCAGGAT: GGGCGCTGTGCCCAGGATA
TAGGTTTTCTGGCGTTGGC: AGGTTTTCTGGCGTTGGCC
TCCCTATGAGGGTTCCTTG: CCCTATGAGGGTTCCTTGA
CTGTGCCCAGGATATTAAC: TGTGCCCAGGATATTAACT
CACTAGACCGATGGTTATG: ACTAGACCGATGGTTATGC
GGACTAGTTTCTCGTTCGA: GACTAGTTTCTCGTTCGAG
GCAATCACAGGGGCAGCAC: CAATCACAGGGGCAGCACA
GCCTGCGTGACCGATCCCG: CCTGCGTGACCGATCCCGC
TTGCGTTCCAACAGAGTTT: TGCGTTCCAACAGAGTTTG
TCGCACGCTTCTTGTGGAC: CGCACGCTTCTTGTGGACC
TTTTACAGGCCTCGCTTTT: TTTACAGGCCTCGCTTTTG
GTCTTGTCGCACGCTTCTT: TCTTGTCGCACGCTTCTTG
CCAGGCTTGCGTTCCAACA: CAGGCTTGCGTTCCAACAG
TCGAGAACGCGTATTAAGG: CGAGAACGCGTATTAAGGT
TCTACATCACGGGCAATAT: CTACATCACGGGCAATATA
CTAGACGTTGACCCCATTC: TAGACGTTGACCCCATTCT
GTAGCCCAAGCACGACTAG: TAGCCCAAGCACGACTAGT
TTTATTTCGCAGCTACTCG: TTATTTCGCAGCTACTCGT
CAGTCGCGGCTGTCACTAA: AGTCGCGGCTGTCACTAAT
TGGCTGGGATGTGAACGAT: GGCTGGGATGTGAACGATC
AGTTGAACTCTACCGCTAT: GTTGAACTCTACCGCTATC
TGTGCAAACACTCCCAGTG: GTGCAAACACTCCCAGTGA
GTTATTTGGGTAATTGAGT: TTATTTGGGTAATTGAGTC
AAACCGGGATGGAGTATAC: AACCGGGATGGAGTATACT
GGCCTGTCTGATAACCGGT: GCCTGTCTGATAACCGGTG
ATCGAGAACGCGTATTAAG: TCGAGAACGCGTATTAAGG
GATAGCGCACTCAGTCGTC: ATAGCGCACTCAGTCGTCA
CCATGTGTTGCGGGAGTGA: CATGTGTTGCGGGAGTGAC
CTCCCCATCAGCGGACCGA: TCCCCATCAGCGGACCGAG
AGCGGATAGATGCCAAAGT: GCGGATAGATGCCAAAGTT
GATGCGTGAGTGGTTCAGC: ATGCGTGAGTGGTTCAGCA
TGCCCAGGATATTAACTAA: GCCCAGGATATTAACTAAA
TTGGGGGAGGCCGTAGCCC: TGGGGGAGGCCGTAGCCCA
CTACCGCTATCTCCGAGTG: TACCGCTATCTCCGAGTGA
GTAGGTTTATTTAATGCTA: TAGGTTTATTTAATGCTAC
TAGCACACAGTGCTCATCA: AGCACACAGTGCTCATCAT
TGTAGTTCCTCTCGACTCT: GTAGTTCCTCTCGACTCTT
GCTGGACCTAGACGTGGCT: CTGGACCTAGACGTGGCTG
GGCGTTGGCCGTCCTTTAC: GCGTTGGCCGTCCTTTACC
CTTGTGGCTAGGAGACTCA: TTGTGGCTAGGAGACTCAC
AGACCGATGGTTATGCAAA: GACCGATGGTTATGCAAAC
GCTGCTCACCTATGAGACA: CTGCTCACCTATGAGACAC
GATAGATGCCAAAGTTGAT: ATAGATGCCAAAGTTGATT
ACATTGGGATCCCAGGCAT: CATTGGGATCCCAGGCATG
AGACCAGTCAGATAGGTTT: GACCAGTCAGATAGGTTTT
AAATCCCCACAAGAGTCTA: AATCCCCACAAGAGTCTAA
TTATTTCGCAGCTACTCGT: TATTTCGCAGCTACTCGTG
TGTCTTCGCTTAGTGAAGT: GTCTTCGCTTAGTGAAGTC
CAAACACTCCCAGTGATGA: AAACACTCCCAGTGATGAT
GAAAAATTTAGTACGCCTG: AAAAATTTAGTACGCCTGT
GAGAGGGGTAGTCACGGTC: AGAGGGGTAGTCACGGTCT
TCGGAACGCACCCGATACC: CGGAACGCACCCGATACCT
ATAGCGCACTCAGTCGTCA: TAGCGCACTCAGTCGTCAC
CATCCAGGCTTGAGGCCCT: ATCCAGGCTTGAGGCCCTC
GCCATAGGAAACACCCGGG: CCATAGGAAACACCCGGGT
GGCAGCGGGCCATTGATAC: GCAGCGGGCCATTGATACA
CTCCCAGTGATTATCACAG: TCCCAGTGATTATCACAGT
TTACTCCTGCGGCGATGTA: TACTCCTGCGGCGATGTAG
GTTGGATTAGGTAGATCGG: TTGGATTAGGTAGATCGGA
CAACGCACCAAGTGACAAT: AACGCACCAAGTGACAATC
CTTATCGCCGGGTTTATCA: TTATCGCCGGGTTTATCAG
CGCGCTGGACCTAGACGTG: GCGCTGGACCTAGACGTGG
TAGTCACGGTCTAGCGGCC: AGTCACGGTCTAGCGGCCG
GTTCCTTGAATTGGGGGAG: TTCCTTGAATTGGGGGAGG
ACTGTTCCTTTGGTAAAAG: CTGTTCCTTTGGTAAAAGA
GAGACGCAGTCGTTCTGAT: AGACGCAGTCGTTCTGATG
CCGGAGTTGCCACAAGGTG: CGGAGTTGCCACAAGGTGG
TTTGGGTAATTGAGTCACC: TTGGGTAATTGAGTCACCT
GGCTAGGTCCGATATCTGT: GCTAGGTCCGATATCTGTC
CGTTAGGCGAGTACGGTAG: GTTAGGCGAGTACGGTAGG
GCCATACTGAAAAATTTAG: CCATACTGAAAAATTTAGT
CCTTGCAACACCAGATTTC: CTTGCAACACCAGATTTCT
ATGTTGTTTCAGGATTCCG: TGTTGTTTCAGGATTCCGT
GTTTTCGCATTTATTTCGC: TTTTCGCATTTATTTCGCA
AGCAATCACAGGGGCAGCA: GCAATCACAGGGGCAGCAC
TGCGTGAGTGGTTCAGCAT: GCGTGAGTGGTTCAGCATG
CACGATGCTCGTTAGGCGA: ACGATGCTCGTTAGGCGAG
GCGAGTACGGTAGGTTTAT: CGAGTACGGTAGGTTTATT
CGGGCACATCATCACCCGC: GGGCACATCATCACCCGCA
GTAAAAGATGATGCGTGAG: TAAAAGATGATGCGTGAGT
TGCCTACCTTGCAACACCA: GCCTACCTTGCAACACCAG
CGGCTAGACGTTGACCCCA: GGCTAGACGTTGACCCCAT
GCGAGACGCAGTCGTTCTG: CGAGACGCAGTCGTTCTGA
TGGCCGTCCTTTACCCCAG: GGCCGTCCTTTACCCCAGA
TTACAGGCCTCGCTTTTGA: TACAGGCCTCGCTTTTGAG
GCGTGACCGATCCCGCCAA: CGTGACCGATCCCGCCAAG
CCCAGACCTAGTGCCTACC: CCAGACCTAGTGCCTACCT
CGGCCATCCTTGATCAAGG: GGCCATCCTTGATCAAGGG
GTCGGACTAGTTTCTCGTT: TCGGACTAGTTTCTCGTTC
ATCCCAGGCATGAGAACCT: TCCCAGGCATGAGAACCTC
GAACCTCATTCTTTAGCTT: AACCTCATTCTTTAGCTTA
CACAGTCGCGGCTGTCACT: ACAGTCGCGGCTGTCACTA
GAGGTCTTATCGCCGGGTT: AGGTCTTATCGCCGGGTTT
TAAAAGACAATAACGAGCT: AAAAGACAATAACGAGCTC
ACACAGGCTAGGTCCGATA: CACAGGCTAGGTCCGATAT
GAGACACTAGTGTGTGAAC: AGACACTAGTGTGTGAACT
GACACTAGCAGTTATCCAT: ACACTAGCAGTTATCCATT
TCGTCCGAAAACAAAGGAG: CGTCCGAAAACAAAGGAGA
TCTGATAACCGGTGCTTGC: CTGATAACCGGTGCTTGCA
ATAGCCGGAGTTGCCACAA: TAGCCGGAGTTGCCACAAG
ATTCTGGAGTTCCGGATGT: TTCTGGAGTTCCGGATGTT
GTTGTCACTCCAGGGACAG: TTGTCACTCCAGGGACAGA
ATGCACGATGCTCGTTAGG: TGCACGATGCTCGTTAGGC
ATTTAATGCTACCCCCGTG: TTTAATGCTACCCCCGTGT
GTGTCTTCGCTTAGTGAAG: TGTCTTCGCTTAGTGAAGT
TCAGCGGATAGATGCCAAA: CAGCGGATAGATGCCAAAG
AGGCCCTCCTTTATCATAG: GGCCCTCCTTTATCATAGG
ATTCTTCTCTACCGCGGAT: TTCTTCTCTACCGCGGATC
TGCAATCTTTCATCCAGGC: GCAATCTTTCATCCAGGCT
TGGTAAAAGATGATGCGTG: GGTAAAAGATGATGCGTGA
AGCAGTTATCCATTGCAAA: GCAGTTATCCATTGCAAAC
CCGATCCCGCCAAGGACCT: CGATCCCGCCAAGGACCTT
ACCGACTAAGCGGCTAGAC: CCGACTAAGCGGCTAGACG
GGTTTTCTGGCGTTGGCCG: GTTTTCTGGCGTTGGCCGT
CGGGATGGAGTATACTCTT: GGGATGGAGTATACTCTTG
TTATTTAATGCTACCCCCG: TATTTAATGCTACCCCCGT
CCAAAGTTGATTGGCATAG: CAAAGTTGATTGGCATAGC
GTCACCTATGAGACACTAG: TCACCTATGAGACACTAGG
GTGGAGGCCTGCGTGACCG: TGGAGGCCTGCGTGACCGA
ACCCGCACCCGCGAAACTG: CCCGCACCCGCGAAACTGC
GAGAGAGGTCTTATCGCCG: AGAGAGGTCTTATCGCCGG
GGCGCTGTGCCCAGGATAT: GCGCTGTGCCCAGGATATT
GCCAAAGTTGATTGGCATA: CCAAAGTTGATTGGCATAG
TTGATCATTTCCAACAGCA: TGATCATTTCCAACAGCAA
GGGGCAGCACAGTGATGCC: GGGCAGCACAGTGATGCCG
GCAGTTATCCATTGCAAAC: CAGTTATCCATTGCAAACA
GGACCTTATCACCTATGAG: GACCTTATCACCTATGAGA
TCTAAAATGGATGATCGTT: CTAAAATGGATGATCGTTT
AACGAGCTCAGTGCCGCAA: ACGAGCTCAGTGCCGCAAC
CACCTATGAGACACTAGGC: ACCTATGAGACACTAGGCC
TGCGTCGAATAACTTGTCA: GCGTCGAATAACTTGTCAC
TCTATTTCACCGGGCACAT: CTATTTCACCGGGCACATC
CGGTTTGGGCCTGTCTGAT: GGTTTGGGCCTGTCTGATA
GTTACTCCTGCGGCGATGT: TTACTCCTGCGGCGATGTA
AAAGGAGATCCCACATATT: AAGGAGATCCCACATATTT
AGATCCCACATATTTCACC: GATCCCACATATTTCACCT
GTCGTTCTGATGCACGATG: TCGTTCTGATGCACGATGC
ATTATTTTACAGGCCTCGC: TTATTTTACAGGCCTCGCT
CGCAGCACCGGCGTCAGAC: GCAGCACCGGCGTCAGACC
ATTGCCATGTGTTGCGGGA: TTGCCATGTGTTGCGGGAG
CCGATATCTGTCTCGGAAC: CGATATCTGTCTCGGAACG
TCCCAGGCATGAGAACCTC: CCCAGGCATGAGAACCTCA
CCCTCCCCATCAGCGGACC: CCTCCCCATCAGCGGACCG
CGTGGCTGGGATGTGAACG: GTGGCTGGGATGTGAACGA
CAATCTTAATTCGCTCCGT: AATCTTAATTCGCTCCGTG
AAAAACCCACACAGGCTAG: AAAACCCACACAGGCTAGG
GGAGTTGTCACTCCAGGGA: GAGTTGTCACTCCAGGGAC
GGTTCAGCATGCTAAACCG: GTTCAGCATGCTAAACCGG
CACTCCCAGTGATTTCTTC: ACTCCCAGTGATTTCTTCT
CAAAATTACCATATTCTGG: AAAATTACCATATTCTGGA
GAACGCGTATTAAGGTCCG: AACGCGTATTAAGGTCCGA
GTTGTTTCAGGATTCCGTG: TTGTTTCAGGATTCCGTGC
GAGTCTAAAATGGATGATC: AGTCTAAAATGGATGATCG
CCTCCGTCGGACTAGTTTC: CTCCGTCGGACTAGTTTCT
TTCCGGATGTTCCCGGGCG: TCCGGATGTTCCCGGGCGC
TGATTTCTTCTCTTCACGA: GATTTCTTCTCTTCACGAA
GGGAGGCCGTAGCCCAAGC: GGAGGCCGTAGCCCAAGCA
AAAGGAGAGAGGTCTTATC: AAGGAGAGAGGTCTTATCG
ACGATCGAGAACGCGTATT: CGATCGAGAACGCGTATTA
TTGCAACACCAGATTTCTA: TGCAACACCAGATTTCTAT
ATGGTTATGCAAACACTCC: TGGTTATGCAAACACTCCC
TGGTTTGTACTCCTCGGAG: GGTTTGTACTCCTCGGAGG
TTCTTTCGCAGCACCGGCG: TCTTTCGCAGCACCGGCGT
TGGTCCTTTATGAGTAACA: GGTCCTTTATGAGTAACAC
GTGCAATCTTTCATCCAGG: TGCAATCTTTCATCCAGGC
CTCCGTGTCTCCCTATGAG: TCCGTGTCTCCCTATGAGG
GGGCGCGCTGGACCTAGAC: GGCGCGCTGGACCTAGACG
CCAGATTTCTATTGGTTGG: CAGATTTCTATTGGTTGGC
CACCAAGTGACAATCTTAA: ACCAAGTGACAATCTTAAT
GGTAATTGAGTCACCTATG: GTAATTGAGTCACCTATGA
GCCGGGTTTATCAGAGAGG: CCGGGTTTATCAGAGAGGG
TACCGCTATCTCCGAGTGA: ACCGCTATCTCCGAGTGAA
CCCATCAGCGGACCGAGTG: CCATCAGCGGACCGAGTGG
CTTTATCATAGGGCGCGCT: TTTATCATAGGGCGCGCTG
TTTGGTTAGATGGTTTGTA: TTGGTTAGATGGTTTGTAC
ATATTAACTAAAAAAACCC: TATTAACTAAAAAAACCCA
AGGGTTCAGCGGATAGATG: GGGTTCAGCGGATAGATGC
AGTCACCTATGAGACACTA: GTCACCTATGAGACACTAG
ACTAGTTTCTCGTTCGAGT: CTAGTTTCTCGTTCGAGTT
TAATAAGACAATGTCCAGC: AATAAGACAATGTCCAGCA
TACTCCTCGGAGGCAGCGG: ACTCCTCGGAGGCAGCGGG
GCATGCTGCGTCGAATAAC: CATGCTGCGTCGAATAACT
CGTAGCCCAAGCACGACTA: GTAGCCCAAGCACGACTAG
TAGTGACGCTGCTCACCTA: AGTGACGCTGCTCACCTAT
ATCTACATCACGGGCAATA: TCTACATCACGGGCAATAT
TACAGCTCAGGGATAGCGC: ACAGCTCAGGGATAGCGCA
GGAAAGCTCCGTGCCAAAT: GAAAGCTCCGTGCCAAATT
TGTGAACGATCGAGAACGC: GTGAACGATCGAGAACGCG
AGTGCCTACCTTGCAACAC: GTGCCTACCTTGCAACACC
CTTGTCACGTCAAAATTAC: TTGTCACGTCAAAATTACC
CAGGGGCTGGTAGTCAGGT: AGGGGCTGGTAGTCAGGTA
ACTAGTCGTCCGAAAACAA: CTAGTCGTCCGAAAACAAA
GGATAGCGCACTCAGTCGT: GATAGCGCACTCAGTCGTC
TGGTTCAGCATGCTAAACC: GGTTCAGCATGCTAAACCG
CGTGTCTCCCTATGAGGGT: GTGTCTCCCTATGAGGGTT
TGGAGTTCCGGATGTTCCC: GGAGTTCCGGATGTTCCCG
AGTCGTTCTGATGCACGAT: GTCGTTCTGATGCACGATG
GACTAGTCGTCCGAAAACA: ACTAGTCGTCCGAAAACAA
CAAACACTCCCAGTGATTA: AAACACTCCCAGTGATTAT
TTCACCTATGAGACACTAG: TCACCTATGAGACACTAGT
TTTATTTAATGCTACCCCC: TTATTTAATGCTACCCCCG
GGGAGTTGTCACTCCAGGG: GGAGTTGTCACTCCAGGGA
TCCCACATATTTCACCTAT: CCCACATATTTCACCTATG
CAGCGGACCGAGTGGAGGC: AGCGGACCGAGTGGAGGCC
TCTTCGCTTAGTGAAGTCC: CTTCGCTTAGTGAAGTCCC
TAGGAAAGCTCCGTGCCAA: AGGAAAGCTCCGTGCCAAA
CAGGCATGAGAACCTCATT: AGGCATGAGAACCTCATTC
ATAGGTTTTCTGGCGTTGG: TAGGTTTTCTGGCGTTGGC
TCACCCGCACCCGCGAAAC: CACCCGCACCCGCGAAACT
CCTTCCCTGGGCGAGACGT: CTTCCCTGGGCGAGACGTT
AGGCAGCGGGCCATTGATA: GGCAGCGGGCCATTGATAC
ACTAAAAAAACCCACACAG: CTAAAAAAACCCACACAGG
TTATGCAAACACTCCCAGT: TATGCAAACACTCCCAGTG
GCTCAGTGCCGCAACGCAC: CTCAGTGCCGCAACGCACC
CACAGGGGCAGCACAGTGA: ACAGGGGCAGCACAGTGAT
TCCCCACAAGAGTCTAAAA: CCCCACAAGAGTCTAAAAT
GTGAGCGAGACGCAGTCGT: TGAGCGAGACGCAGTCGTT
CCCAGTGATTTCTTCTCTT: CCAGTGATTTCTTCTCTTC
AAAGCTCCGTGCCAAATTG: AAGCTCCGTGCCAAATTGC
GACCTAAAAGACAATAACG: ACCTAAAAGACAATAACGA
CTTGTGGACCTAAAAGACA: TTGTGGACCTAAAAGACAA
CGTCACCGACTAAGCGGCT: GTCACCGACTAAGCGGCTA
AAGTGACAATCTTAATTCG: AGTGACAATCTTAATTCGC
CTGCGTGACCGATCCCGCC: TGCGTGACCGATCCCGCCA
ATAGGGCGCGCTGGACCTA: TAGGGCGCGCTGGACCTAG
CTCGCCCTCTTAATTAATC: TCGCCCTCTTAATTAATCA
GAAGTATTGCGCAGGGGCT: AAGTATTGCGCAGGGGCTG
CCCATTCTTCTCTACCGCG: CCATTCTTCTCTACCGCGG
CGGGCAATATAGGAAAGCT: GGGCAATATAGGAAAGCTC
AATAACGAGCTCAGTGCCG: ATAACGAGCTCAGTGCCGC
ACTCCAGGGACAGAAAGGA: CTCCAGGGACAGAAAGGAG
GCTTCTTGTGGACCTAAAA: CTTCTTGTGGACCTAAAAG
TCAAAATTACCATATTCTG: CAAAATTACCATATTCTGG
AGGAAAGCTCCGTGCCAAA: GGAAAGCTCCGTGCCAAAT
TTATCAGAGAGGGGTAGTC: TATCAGAGAGGGGTAGTCA
CCAACAGCAATCACAGGGG: CAACAGCAATCACAGGGGC
GGTCCGATATCTGTCTCGG: GTCCGATATCTGTCTCGGA
GTTAGTCCTCGCCCTCTTA: TTAGTCCTCGCCCTCTTAA
TCCCGGAGTTGGATTAGGT: CCCGGAGTTGGATTAGGTA
GACTCCAGGCTTGCGTTCC: ACTCCAGGCTTGCGTTCCA
TCATCCAGGCTTGAGGCCC: CATCCAGGCTTGAGGCCCT
TATTTAATGCTACCCCCGT: ATTTAATGCTACCCCCGTG
AAGTATTGCGCAGGGGCTG: AGTATTGCGCAGGGGCTGG
CACAAGGTGGGAGGCCAAC: ACAAGGTGGGAGGCCAACC
ATAATACCAGCCATACTGA: TAATACCAGCCATACTGAA
TGCCTCCGTCGGACTAGTT: GCCTCCGTCGGACTAGTTT
GATATTAACTAAAAAAACC: ATATTAACTAAAAAAACCC
CGCACCCGCGAAACTGCAT: GCACCCGCGAAACTGCATC
CCGGGTGACTAGTCTGTGC: CGGGTGACTAGTCTGTGCA
GGTAAAAGATGATGCGTGA: GTAAAAGATGATGCGTGAG
TGAGTAACACTGTTCCTTT: GAGTAACACTGTTCCTTTG
CGAGGGTTCAGCGGATAGA: GAGGGTTCAGCGGATAGAT
AAGACAATAACGAGCTCAG: AGACAATAACGAGCTCAGT
TGATACAGCTCAGGGATAG: GATACAGCTCAGGGATAGC
TAATCACAGTCGCGGCTGT: AATCACAGTCGCGGCTGTC
ATATTCTGGAGTTCCGGAT: TATTCTGGAGTTCCGGATG
CACTAATTTGCCTCCGTCG: ACTAATTTGCCTCCGTCGG
CTCCAGGCTTGCGTTCCAA: TCCAGGCTTGCGTTCCAAC
TATCTCCGAGTGAATCCCG: ATCTCCGAGTGAATCCCGG
AGCATGGTTAGTCCTCGCC: GCATGGTTAGTCCTCGCCC
GCCTGTTCGCGTTACTCCT: CCTGTTCGCGTTACTCCTG
CCCCCGTGTCTTCGCTTAG: CCCCGTGTCTTCGCTTAGT
TCTACCGCTATCTCCGAGT: CTACCGCTATCTCCGAGTG
TTATGAGTAACACTGTTCC: TATGAGTAACACTGTTCCT
GGCGAGACGTTCTATTTCA: GCGAGACGTTCTATTTCAC
TCTCGTTCGAGTTATAGTG: CTCGTTCGAGTTATAGTGA
AGTGGAGGCCTGCGTGACC: GTGGAGGCCTGCGTGACCG
GTTTGGTCCTTTATGAGTA: TTTGGTCCTTTATGAGTAA
AACCTCATTCTTTAGCTTA: ACCTCATTCTTTAGCTTAG
GGCTAGACGTTGACCCCAT: GCTAGACGTTGACCCCATT
ATTGCGCAGGGGCTGGTAG: TTGCGCAGGGGCTGGTAGT
GGTGGGAGGCCAACCTTCC: GTGGGAGGCCAACCTTCCC
TTAAGCCTGTTCGCGTTAC: TAAGCCTGTTCGCGTTACT
CTGTACTTGGGTTATTTGG: TGTACTTGGGTTATTTGGG
CCTTTGGTAAAAGATGATG: CTTTGGTAAAAGATGATGC
AGACAATAACGAGCTCAGT: GACAATAACGAGCTCAGTG
CTCACACATTGGGATCCCA: TCACACATTGGGATCCCAG
CTATTTCACCGGGCACATC: TATTTCACCGGGCACATCA
CCATTCTAGATCTACATCA: CATTCTAGATCTACATCAC
GATATCTGTCTCGGAACGC: ATATCTGTCTCGGAACGCA
AAAACCCACACAGGCTAGG: AAACCCACACAGGCTAGGT
GTCAAAATTACCATATTCT: TCAAAATTACCATATTCTG
TAGGAGACTCACACATTGG: AGGAGACTCACACATTGGG
GATGGTTATGCAAACACTC: ATGGTTATGCAAACACTCC
TACCAATAATCATTGTGAG: ACCAATAATCATTGTGAGT
CGTTAAGCCTGTTCGCGTT: GTTAAGCCTGTTCGCGTTA
CCTCTCGACTCTTCTTTCG: CTCTCGACTCTTCTTTCGC
CAGGATTCCGTGCCATAGG: AGGATTCCGTGCCATAGGA
TACCTTGCAACACCAGATT: ACCTTGCAACACCAGATTT
GGCTTGAGGCCCTCCTTTA: GCTTGAGGCCCTCCTTTAT
ACCCGCGAAACTGCATCTA: CCCGCGAAACTGCATCTAC
GAGACGTTCTATTTCACCG: AGACGTTCTATTTCACCGG
ACTTTGCAAACACTCCCAG: CTTTGCAAACACTCCCAGT
GGTAGATCGGACTCCAGGC: GTAGATCGGACTCCAGGCT
TCCGGATGTTCCCGGGCGC: CCGGATGTTCCCGGGCGCT
ATAGGAAAGCTCCGTGCCA: TAGGAAAGCTCCGTGCCAA
AGACACTAGTGTGTGAACT: GACACTAGTGTGTGAACTT
ATCACAGTCGCGGCTGTCA: TCACAGTCGCGGCTGTCAC
TTCTTCTCTACCGCGGATC: TCTTCTCTACCGCGGATCT
TTAGGCGAGTACGGTAGGT: TAGGCGAGTACGGTAGGTT
CTAATAAGACAATGTCCAG: TAATAAGACAATGTCCAGC
CCATAGGAAACACCCGGGT: CATAGGAAACACCCGGGTG
GTGACGAGAAATAATACCA: TGACGAGAAATAATACCAG
AGCGGACCGAGTGGAGGCC: GCGGACCGAGTGGAGGCCT
CTCTACCGCTATCTCCGAG: TCTACCGCTATCTCCGAGT
AGTTTGGTCCTTTATGAGT: GTTTGGTCCTTTATGAGTA
AATCCCCACAAGAGTCTAA: ATCCCCACAAGAGTCTAAA
TTCTTTAGCTTAGCACACA: TCTTTAGCTTAGCACACAG
ATATCTGTCTCGGAACGCA: TATCTGTCTCGGAACGCAC
CACACAGTGCTCATCATCC: ACACAGTGCTCATCATCCA
GCGGCCGGGATTCTAATAA: CGGCCGGGATTCTAATAAG
TTTGTACTCCTCGGAGGCA: TTGTACTCCTCGGAGGCAG
AGGCTAGGTCCGATATCTG: GGCTAGGTCCGATATCTGT
GTTATGCAAACACTCCCAG: TTATGCAAACACTCCCAGT
AGAACGCGTATTAAGGTCC: GAACGCGTATTAAGGTCCG
TTTGGTCCTTTATGAGTAA: TTGGTCCTTTATGAGTAAC
GACCGATCCCGCCAAGGAC: ACCGATCCCGCCAAGGACC
TGATTTATGTACCAATAAT: GATTTATGTACCAATAATC
GGACCTAGACGTGGCTGGG: GACCTAGACGTGGCTGGGA
AGCTCAGTGCCGCAACGCA: GCTCAGTGCCGCAACGCAC
AGCCCAAGCACGACTAGTC: GCCCAAGCACGACTAGTCG
GTGGACCTAAAAGACAATA: TGGACCTAAAAGACAATAA
CCTGGGCGAGACGTTCTAT: CTGGGCGAGACGTTCTATT
TATTTTACAGGCCTCGCTT: ATTTTACAGGCCTCGCTTT
CTGGGATGTGAACGATCGA: TGGGATGTGAACGATCGAG
CGACTAGTCGTCCGAAAAC: GACTAGTCGTCCGAAAACA
CACCTATGAGACACTAGTG: ACCTATGAGACACTAGTGT
ATAGCATGGTTAGTCCTCG: TAGCATGGTTAGTCCTCGC
TACCTTTGGTTAGATGGTT: ACCTTTGGTTAGATGGTTT
